a	indefinite article	 
about	prep., adv.	 
above	prep., adv.	 
across	prep., adv.	 
action	n.	 
activity	n.	 
actor	n.	 
actress	n.	 
add	v.	 
address	n.	 
adult	n.	 
advice	n.	 
afraid	adj.	 
after	prep.	 
afternoon	n.	 
again	adv.	 
age	n.	 
ago	adv.	 
agree	v.	 
air	n.	 
airport	n.	 
all	det., pron.	 
also	adv.	 
always	adv.	 
amazing	adj.	 
and	conj.	 
angry	adj.	 
animal	n.	 
another	det./pron.	 
answer	n., v.	 
any	det., pron.	 
anyone	pron.	 
anything	pron.	 
apartment	n.	 
apple	n.	 
April	n.	 
area	n.	 
arm	n.	 
around	prep., adv.	 
arrive	v.	 
art	n.	 
article	n.	 
artist	n.	 
as	prep.	 
ask	v.	 
at	prep.	 
August	n.	 
aunt	n.	 
autumn	n.	 
away	adv.	 
baby	n.	 
back	n., adv.	 
bad	adj.	 
bag	n.	 
ball	n.	 
banana	n.	 
band	n.	 
bank	(money) n.	 
bath	n.	 
bathroom	n.	 
be	v., auxiliary v.	 
beach	n.	 
beautiful	adj.	 
because	conj.	 
become	v.	 
bed	n.	 
bedroom	n.	 
beer	n.	 
before	prep.	 
begin	v.	 
beginning	n.	 
behind	prep., adv.	 
believe	v.	 
below	adv., prep.	 
best	adj.	 
better	adj.	 
between	prep.	 
bicycle	n.	 
big	adj.	 
bike	n.	 
bill	n.	 
bird	n.	 
birthday	n.	 
black	adj., n.	 
blog	n.	 
blonde	adj.	 
blue	adj., n.	 
boat	n.	 
body	n.	 
book	n.	 
boot	n.	 
bored	adj.	 
boring	adj.	 
born	v.	 
both	det./pron.	 
bottle	n.	 
box	n.	 
boy	n.	 
boyfriend	n.	 
bread	n.	 
break	v., n.	 
breakfast	n.	 
bring	v.	 
brother	n.	 
brown	adj., n.	 
build	v.	 
building	n.	 
bus	n.	 
business	n.	 
busy	adj.	 
but	conj.	 
butter	n.	 
buy	v.	 
by	prep.	 
bye	exclam.	 
cafe	n.	 
cake	n.	 
call	v., n.	 
camera	n.	 
can	modal v.	 
cannot	modal v.	 
capital	n., adj.	 
car	n.	 
card	n.	 
career	n.	 
carrot	n.	 
carry	v.	 
cat	n.	 
CD	n.	 
cent	n.	 
centre	n.	 
century	n.	 
chair	n.	 
change	v., n.	 
chart	n.	 
cheap	adj.	 
check	v.	 
cheese	n.	 
chicken	n.	 
child	n.	 
chocolate	n.	 
choose	v.	 
cinema	n.	 
city	n.	 
class	n.	 
classroom	n.	 
clean	adj., v.	 
climb	v.	 
clock	n.	 
close	v.	 
clothes	n.	 
club	n.	 
coat	n.	 
coffee	n.	 
cold	adj., n.	 
college	n.	 
colour	n.	 
come	v.	 
common	adj.	 
company	n.	 
compare	v.	 
complete	adj., v.	 
computer	n.	 
concert	n.	 
conversation	n.	 
cook	v.	 
cooking	n.	 
cool	adj.	 
correct	adj., v.	 
cost	n., v.	 
could	modal v.	 
country	n.	 
course	n.	 
cousin	n.	 
cow	n.	 
cream	n.	 
create	v.	 
culture	n.	 
cup	n.	 
customer	n.	 
cut	v.	 
dad	n.	 
dance	n., v.	 
dancer	n.	 
dancing	n.	 
dangerous	adj.	 
dark	adj.	 
date	n.	 
daughter	n.	 
day	n.	 
dear	adj.	 
December	n.	 
decide	v.	 
delicious	adj.	 
describe	v.	 
description	n.	 
design	n., v.	 
desk	n.	 
detail	n.	 
dialogue	n.	 
dictionary	n.	 
die	v.	 
diet	n.	 
difference	n.	 
different	adj.	 
difficult	adj.	 
dinner	n.	 
dirty	adj.	 
discuss	v.	 
dish	n.	 
do	v., auxiliary v.	 
doctor	n.	 
dog	n.	 
dollar	n.	 
door	n.	 
down	adv., prep.	 
downstairs	adv.	 
draw	v.	 
dress	n., v.	 
drink	n., v.	 
drive	v.	 
driver	n.	 
during	prep.	 
DVD	n.	 
each	det./pron./adv.	 
ear	n.	 
early	adj., adv.	 
east	n., adj., adv.	 
easy	adj.	 
eat	v.	 
egg	n.	 
eight	number	 
eighteen	number	 
eighty	number	 
elephant	n.	 
eleven	number	 
else	adv.	 
email	n., v.	 
end	n., v.	 
enjoy	v.	 
enough	det., pron., adv.	 
euro	n.	 
even	adv.	 
evening	n.	 
event	n.	 
ever	adv.	 
every	det.	 
everybody	pron.	 
everyone	pron.	 
everything	pron.	 
exam	n.	 
example	n.	 
excited	adj.	 
exciting	adj.	 
exercise	n., v.	 
expensive	adj.	 
explain	v.	 
extra	adj.	 
eye	n.	 
face	n.	 
fact	n.	 
fall	v.	 
false	adj.	 
family	n., adj.	 
famous	adj.	 
fantastic	adj.	 
far	adv.	 
farm	n.	 
farmer	n.	 
fast	adj., adv.	 
fat	adj.	 
father	n.	 
favourite	adj., n.	 
February	n.	 
feel	v.	 
feeling	n.	 
festival	n.	 
few	det./adj., pron.	 
fifteen	number	 
fifth	number	 
fifty	number	 
fill	v.	 
film	n.	 
final	adj.	 
find	v.	 
fine	adj.	 
finish	v.	 
fire	n.	 
first	det./number, adv.	 
fish	n.	 
five	number	 
flat	n.	 
flight	n.	 
floor	n.	 
flower	n.	 
fly	v.	 
follow	v.	 
food	n.	 
foot	n.	 
football	n.	 
for	prep.	 
forget	v.	 
form	n., v.	 
forty	number	 
four	number	 
fourteen	number	 
fourth	number	 
free	adj.	 
Friday	n.	 
friend	n.	 
friendly	adj.	 
from	prep.	 
front	n., adj.	 
fruit	n.	 
full	adj.	 
fun	n.	 
funny	adj.	 
future	n.	 
game	n.	 I like to play games in my free time.	నాకు నా ఖాళీ సమయంలో ఆటలు ఆడటం ఇష్టం.	ఆడటం 
garden	n.	 There are many flowers in the garden.	తోటలో అనేక పూలు ఉన్నాయి.	తోట 
geography	n.	 Geography is my favorite subject.	భూగోళ శాస్త్రం నా ప్రియమైన విషయం.	భూగోళ శాస్త్రం 
get	v.	 Can you get me a glass of water?	మీరు నాకు ఒక గ్లాస్ నీరు తెస్తారా?	 తెస్తారా
girl	n.	 The girl is reading a book.	ఆ అమ్మాయి పుస్తకం చదువుతోంది.	అమ్మాయి 
girlfriend	n.	 He is talking to his girlfriend.	అతను తన స్నేహితురాలితో మాట్లాడుతున్నాడు.	స్నేహితురాలితో 
give	v.	 Please give me your phone number.	దయచేసి మీ ఫోన్ నంబర్ ఇవ్వండి.	 ఇవ్వండి
glass	n.	 This glass is full of water.	ఈ గ్లాస్ నీటితో నిండి ఉంది.	గ్లాస్ 
go	v.	 I go to the market every Sunday.	నేను ప్రతి ఆదివారం మార్కెట్‌కు వెళ్తాను.	 వెళ్తాను
good	adj.	 This is a very good idea.	ఇది చాలా మంచి ఆలోచన.	మంచి 
goodbye	exclam./n.	 Goodbye! See you tomorrow.	గుడ్‌బై! రేపు కలుద్దాం.	గుడ్‌‌బై
grandfather	n.	 My grandfather tells great stories.	నా తాత గౌరవనీయమైన కథలు చెబుతారు.	తాత 
grandmother	n.	 My grandmother makes delicious food.	నా అమ్మమ్మ రుచికరమైన ఆహారం తయారు చేస్తుంది.	అమ్మమ్మ 
grandparent	n.	 Spending time with my grandparents is fun.	నా తాతమ్మలతో గడపటం చాలా ఆనందం.	తాతమ్మలతో 
great	adj.	 You did a great job!	మీరు గొప్ప పని చేశారు!	గొప్ప 
green	adj., n.	 The grass in the park is green.	పార్కులోని గడ్డి పచ్చగా ఉంది.	పచ్చగా 
grey	adj., n.	 The sky is grey because of the clouds.	మబ్బుల వల్ల ఆకాశం గోధుమరంగులో ఉంది.	గోధుమరంగులో 
group	n.	 They are working in a group.	వారు ఒక సమూహంలో పని చేస్తున్నారు.	సమూహంలో 
grow	v.	 Plants grow faster with sunlight.	మొక్కలు సూర్యరశ్మితో త్వరగా పెరుగుతాయి.	 పెరుగుతాయి
guess	v., n.	 Can you guess the answer?	మీరు సమాధానం ఊహించగలారా?	 ఊహించగలారా
guitar	n.	 He is learning to play the guitar.	అతను గిటార్ వాయించడం నేర్చుకుంటున్నాడు.	గిటార్ 
gym	n.	 I go to the gym every evening.	నేను ప్రతి సాయంత్రం జిమ్‌కు వెళ్తాను.	 జిమ్
hair	n.	 Her hair is very long.	ఆమె జుట్టు చాలా పొడవుగా ఉంది.	జుట్టు 
half	n., det./pron.	 I finished half of the work.	నేను పనిలో సగం పూర్తి చేశాను.	సగం 
hand	n.	 She held my hand tightly.	ఆమె నా చెయ్యిని గట్టిగా పట్టుకుంది.	చెయ్యిని 
happen	v.	 
happy	adj.	 
hard	adj., adv.	 
hat	n.	 
hate	v.	 
have	v.	 
have	to modal v.	 
he	pron.	 
head	n.	 
health	n.	 
healthy	adj.	 
hear	v.	 
hello	exclam./n.	 
help	v., n.	 
her	pron., det.	 
here	adv.	 
hey	exclam.	 
hi	exclam.	 
high	adj.	 
him	pron.	 
his	det.	 
history	n.	 
hobby	n.	 
holiday	n.	 
home	n., adv.	 
homework	n.	 
hope	v.	 
horse	n.	 
hospital	n.	 
hot	adj.	 
hotel	n.	 
hour	n.	 
house	n.	 
how	adv.	 
however	adv.	 
hundred	number	 
hungry	adj.	 
husband	n.	 
I	pron.	 
ice	n.	 
ice	cream n.	 
idea	n.	 
if	conj.	 
imagine	v.	 
important	adj.	 
improve	v.	 
in	prep., adv.	 
include	v.	 
information	n.	 
interest	n., v.	 
interested	adj.	 
interesting	adj.	 
internet	n.	 
interview	n., v.	 
into	prep.	 
introduce	v.	 
island	n.	 
it	pron.	 
its	det.	 
jacket	n.	 
January	n.	 
jeans	n.	 
job	n.	 
join	v.	 
journey	n.	 
juice	n.	 
July	n.	 
June	n.	 
just	adv.	 
keep	v.	 
key	n., adj.	 
kilometre	n.	 
kind	(type) n.	 
kitchen	n.	 
know	v.	 
land	n.	 
language	n.	 
large	adj.	 
last	(final) det.	 
late	adj., adv.	 
later	adv.	 
laugh	v., n.	 
learn	v.	 
leave	v.	 
left	adj., adv., n.	 
leg	n.	 
lesson	n.	 
let	v.	 
letter	n.	 
library	n.	 
lie	v.	 
life	n.	 
light	(from the sun/a lamp) n., adj.	 
like	(similar) prep.	 
like	(find pleasant) v.	 
line	n.	 
lion	n.	 
list	n., v.	 
listen	v.	 
little	adj., det./pron.	 
live	v.	 
local	adj.	 
long	adj., adv.	 
look	v.	 
lose	v.	 
lot	pron., det., adv.	 
love	n., v.	 
lunch	n.	 
machine	n.	 
magazine	n.	 
main	adj.	 
make	v.	 
man	n.	 
many	det./pron.	 
map	n.	 
March	n.	 
market	n.	 
married	adj.	 
match	(contest/correspond) n., v.	 
May	n.	 
maybe	adv.	 
me	pron.	 
meal	n.	 
mean	v.	 
meaning	n.	 
meat	n.	 
meet	v.	 
meeting	n.	 
member	n.	 
menu	n.	 
message	n.	 
metre	n.	 
midnight	n.	 
mile	n.	 
milk	n.	 
million	number	 
minute	n.	 
miss	v.	 
mistake	n.	 
model	n.	 
modern	adj.	 
moment	n.	 
Monday	n.	 
money	n.	 
month	n.	 
more	det./pron., adv.	 
morning	n.	 
most	det./pron., adv.	 
mother	n.	 
mountain	n.	 
mouse	n.	 
mouth	n.	 
move	v.	 
movie	n.	 
much	det./pron., adv.	 
mum	n.	 
museum	n.	 
music	n.	 
must	modal v.	 
my	det.	 
name	n., v.	 
natural	adj.	 
near	prep., adj., adv.	 
need	v.	 
negative	adj.	 
neighbour	n.	 
never	adv.	 
new	adj.	 
news	n.	 
newspaper	n.	 
next	adj., adv.	 
next	to prep.	 
nice	adj.	 
night	n.	 
nine	number	 
nineteen	number	 
ninety	number	 
no	exclam., det.	 
no one	pron.	 
nobody	pron.	 
north	n., adj., adv.	 
nose	n.	 
not	adv.	 
note	n.	 
nothing	pron.	 
November	n.	 
now	adv.	 
number	n.	 
nurse	n.	 
object	n.	 
o’clock	adv.	 
October	n.	 
of	prep.	 
off	adv., prep.	 
office	n.	 
often	adv.	 
oh	exclam.	 
OK	exclam., adj./adv.	 
old	adj.	 
on	prep., adv.	 
once	adv.	 
one	number/det., pron.	 
onion	n.	 
online	adj., adv.	 
only	adj., adv.	 
open	adj., v.	 
opinion	n.	 
opposite	adj., n., prep., adv.	 
or	conj.	 
orange	n., adj.	 
order	n., v.	 
other	adj./pron.	 
our	det.	 
out	adv./prep.	 
outside	adv.	 
over	prep., adv.	 
own	adj./pron.	 
page	n.	 
paint	v., n.	 
painting	n.	 
pair	n.	 
paper	n.	 
paragraph	n.	 
parent	n.	 
park	n., v.	 
part	n.	 
partner	n.	 
party	n.	 
passport	n.	 
past	adj., n., prep.	 
pay	v.	 
pen	n.	 
pencil	n.	 
people	n.	 
pepper	n.	 
perfect	adj.	 
period	n.	 
person	n.	 
personal	adj.	 
phone	n., v.	 
photo	n.	 
photograph	n.	 
phrase	n.	 
piano	n.	 
picture	n.	 
piece	n.	 
pig	n.	 
pink	adj., n.	 
place	n.	 
plan	n., v.	 
plane	n.	 
plant	n.	 
play	v., n.	 
player	n.	 
please	exclam.	 
point	n.	 
police	n.	 
policeman	n.	 
pool	n.	 
poor	adj.	 
popular	adj.	 
positive	adj.	 
possible	adj.	 
post	n., v.	 
potato	n.	 
pound	n.	 
practice	n.	 
practise	v.	 
prefer	v.	 
prepare	v.	 
present	adj., n.	 
pretty	adj., adv.	 
price	n.	 
probably	adv.	 
problem	n.	 
product	n.	 
programme	n.	 
project	n.	 
purple	adj., n.	 
put	v.	 
quarter	n.	 
question	n.	 
quick	adj.	 
quickly	adv.	 
quiet	adj.	 
quite	adv.	 
radio	n.	 
rain	n., v.	 
read	v.	 
reader	n.	 
reading	n.	 
ready	adj.	 
real	adj.	 
really	adv.	 
reason	n.	 
red	adj., n.	 
relax	v.	 
remember	v.	 
repeat	v.	 
report	n.	 
restaurant	n.	 
result	n.	 
return	v., n.	 
rice	n.	 
rich	adj.	 
ride	v.	 
right	adj., adv., n.	 
river	n.	 
road	n.	 
room	n.	 
routine	n.	 
rule	n.	 
run	v.	 
sad	adj.	 
salad	n.	 
salt	n.	 
same	adj., pron., adv.	 
sandwich	n.	 
Saturday	n.	 
say	v.	 
school	n.	 
science	n.	 
scientist	n.	 
sea	n.	 
second (next after the first)	det./number	 
second (unit of time)	n.	 
section	n.	 
see	v.	 
sell	v.	 
send	v.	 
sentence	n.	 
September	n.	 
seven	number	 
seventeen	number	 
seventy	number	 
share	v.	 
she	pron.	 
sheep	n.	 
shirt	n.	 
shoe	n.	 
shop	n., v.	 
shopping	n.	 
short	adj.	 
should	modal v.	 
show	v., n.	 
shower	n.	 
sick	adj.	 
similar	adj.	 
sing	v.	 
singer	n.	 
sister	n.	 
sit	v.	 
situation	n.	 
six	number	 
sixteen	number	 
sixty	number	 
skill	n.	 
skirt	n.	 
sleep	v.	 
slow	adj.	 
small	adj.	 
snake	n.	 
snow	n., v.	 
so	adv., conj.	 
some	det., pron.	 
somebody	pron.	 
someone	pron.	 
something	pron.	 
sometimes	adv.	 
son	n.	 
song	n.	 
soon	adv.	 
sorry	adj., exclam.	 
sound	n., v.	 
soup	n.	 
south	n., adj., adv.	 
space	n.	 
speak	v.	 
special	adj.	 
spell	v.	 
spelling	n.	 
spend	v.	 
sport	n.	 
spring	n.	 
stand	v.	 
star	n.	 
start	v.	 
statement	n.	 
station	n.	 
stay	v.	 
still	adv.	 
stop	v., n.	 
story	n.	 
street	n.	 
strong	adj.	 
student	n.	 
study	n., v.	 
style	n.	 
subject	n.	 
success	n.	 
sugar	n.	 
summer	n.	 
sun	n.	 
Sunday	n.	 
supermarket	n.	 
sure	adj.	 
sweater	n.	 
swim	v.	 
swimming	n.	 
table	n.	 
take	v.	 
talk	v.	 
tall	adj.	 
taxi	n.	 
tea	n.	 
teach	v.	 
teacher	n.	 
team	n.	 
teenager	n.	 
telephone	n., v.	 
television	n.	 
tell	v.	 
ten	number	 
tennis	n.	 
terrible	adj.	 
test	n., v.	 
text	n.	 
than	conj.	 
thank	v.	 
thanks	exclam., n.	 
that	det., pron., conj.	 
the	definite article	 
theatre	n.	 
their	det.	 
them	pron.	 
then	adv.	 
there	adv.	 
they	pron.	 
thing	n.	 
think	v.	 
third	number	 
thirsty	adj.	 
thirteen	number	 
thirty	number	 
this	det./pron.	 
thousand	number	 
three	number	 
through	prep., adv.	 
Thursday	n.	 
ticket	n.	 
time	n.	 
tired	adj.	 
title	n.	 
to	prep., infinitive marker	 
today	adv., n.	 
together	adv.	 
toilet	n.	 
tomato	n.	 
tomorrow	adv., n.	 
tonight	adv., n.	 
too	adv.	 
tooth	n.	 
topic	n.	 
tourist	n.	 
town	n.	 
traffic	n.	 
train	n.	 
travel	v., n.	 
tree	n.	 
trip	n.	 
trousers	n.	 
true	adj.	 
try	v.	 
T-shirt	n.	 
Tuesday	n.	 
turn	v., n.	 
TV	n.	 
twelve	number	 
twenty	number	 
twice	adv.	 
two	number	 
type	n.	 
umbrella	n.	 
uncle	n.	 
under	prep., adv.	 
understand	v.	 
university	n.	 
until	conj./prep.	 
up	adv., prep.	 
upstairs	adv.	 
us	pron.	 
use	v.	 
useful	adj.	 
usually	adv.	 
vacation	n.	 
vegetable	n.	 
very	adv.	 
video	n.	 
village	n.	 
visit	v., n.	 
visitor	n.	 
wait	v.	 
waiter	n.	 
wake	v.	 
walk	v., n.	 
wall	n.	 
want	v.	 
warm	adj.	 
wash	v.	 
watch	v., n.	 
water	n.	 
way	n.	 
we	pron.	 
wear	v.	 
weather	n.	 
website	n.	 
Wednesday	n.	 
week	n.	 
weekend	n.	 
welcome	exclam., v., adj.	 
well	adv., adj., exclam.	 
west	n., adj., adv.	 
what	pron./det.	 
when	adv., pron., conj.	 
where	adv., conj.	 
which	pron./det.	 
white	adj., n.	 
who	pron.	 
why	adv.	 
wife	n.	 
will	modal v.	 
win	v.	 
window	n.	 
wine	n.	 
winter	n.	 
with	prep.	 
without	prep.	 
woman	n.	 
wonderful	adj.	 
word	n.	 
work	v., n.	 
worker	n.	 
world	n.	 
would	modal v.	 
write	v.	 
writer	n.	 
writing	n.	 
wrong	adj.	 
yeah	exclam.	 
year	n.	 
yellow	adj., n.	 
yes	exclam.	 
yesterday	adv., n.	 
you	pron.	 
young	adj.	 
your	det.	 
yourself	pron.	 



