a 	 ఒక 	(Oka)	
abandon 	 విడిచిపెట్టు 	(Viḍicipeṭṭu)	
abandoned 	 విడిచిపెట్టారు 	(Viḍicipeṭṭāru)	
ability 	 సామర్థ్యం 	(Sāmarthyaṁ)	
able 	 చేయగలరు 	(Cēyagalaru)	
about 	 గురించి 	(Gurin̄ci)	
above 	 పైన 	(Paina)	
abroad 	 విదేశాలలో 	(Vidēśālalō)	
absence 	 లేకపోవడం 	(Lēkapōvaḍaṁ)	
absent 	 గైర్హాజరు 	(Gair'hājaru)	
absolute 	 సంపూర్ణమైన 	(Sampūrṇamaina)	
absolutely 	 ఖచ్చితంగా 	(Khaccitaṅgā)	
absorb 	 గ్రహిస్తాయి 	(Grahistāyi)	
abuse 	 దుర్వినియోగం 	(Durviniyōgaṁ)	
academic 	 విద్యాసంబంధమైన 	(Vidyāsambandhamaina)	
accent 	 యాస 	(Yāsa)	
accept 	 అంగీకరించు 	(Aṅgīkarin̄cu)	
acceptable 	 ఆమోదయోగ్యమైనది 	(Āmōdayōgyamainadi)	
access 	 యాక్సెస్ 	(Yākses)	
accident 	 ప్రమాదం 	(Pramādaṁ)	
accidental 	 ప్రమాదవశాత్తు 	(Pramādavaśāttu)	
accidentally 	 అనుకోకుండా 	(Anukōkuṇḍā)	
accommodation 	 వసతి 	(Vasati)	
accompany 	 తోడు 	(Tōḍu)	
according to 	 ప్రకారం 	(Prakāraṁ)	
account 	 ఖాతా 	(Khātā)	
account for 	 కోసం ఖాతా 	(Kōsaṁ khātā)	
accurate 	 ఖచ్చితమైన 	(Khaccitamaina)	
accurately 	 ఖచ్చితంగా 	(Khaccitaṅgā)	
accuse 	 నిందిస్తారు 	(Nindistāru)	
achieve 	 సాధిస్తారు 	(Sādhistāru)	
achievement 	 సాధించిన 	(Sādhin̄cina)	
acid 	 యాసిడ్ 	(Yāsiḍ)	
acknowledge 	 గుర్తించండి 	(Gurtin̄caṇḍi)	
a couple 	 ఒక జంట 	(Oka jaṇṭa)	
acquire 	 సంపాదించు 	(Sampādin̄cu)	
across 	 అంతటా 	(Antaṭā)	
act 	 చట్టం 	(Caṭṭaṁ)	
action 	 చర్య 	(Carya)	
active 	 చురుకుగా 	(Curukugā)	
actively 	 చురుకుగా 	(Curukugā)	
activity 	 కార్యాచరణ 	(Kāryācaraṇa)	
actor 	 నటుడు 	(Naṭuḍu)	
actress 	 నటి 	(Naṭi)	
actual 	 అసలు 	(Asalu)	
actually 	 నిజానికి 	(Nijāniki)	
ad 	 ప్రకటన 	(Prakaṭana)	
adapt 	 స్వీకరించు 	(Svīkarin̄cu)	
add 	 జోడించు 	(Jōḍin̄cu)	
addition 	 అదనంగా 	(Adanaṅgā)	
additional 	 అదనపు 	(Adanapu)	
add on 	 జోడించు 	(Jōḍin̄cu)	
address 	 చిరునామా 	(Cirunāmā)	
add up 	 చేర్చండి 	(Cērcaṇḍi)	
add up to 	 వరకు జోడించండి 	(Varaku jōḍin̄caṇḍi)	
adequate 	 తగినంత 	(Taginanta)	
adequately 	 తగినంతగా 	(Taginantagā)	
adjust 	 సర్దుబాటు 	(Sardubāṭu)	
admiration 	 మెచ్చుకోవడం 	(Meccukōvaḍaṁ)	
admire 	 మెచ్చుకుంటారు 	(Meccukuṇṭāru)	
admit 	 ఒప్పుకుంటారు 	(Oppukuṇṭāru)	
adopt 	 స్వీకరించు 	(Svīkarin̄cu)	
adult 	 పెద్దలు 	(Peddalu)	
advance 	 ముందుకు 	(Munduku)	
advanced 	 అభివృద్ధి చెందింది 	(Abhivr̥d'dhi cendindi)	
advantage 	 ప్రయోజనం 	(Prayōjanaṁ)	
adventure 	 సాహసం 	(Sāhasaṁ)	
advert 	 ప్రకటన 	(Prakaṭana)	
advertise 	 ప్రచారం చేయండి 	(Pracāraṁ cēyaṇḍi)	
advertisement 	 ప్రకటన 	(Prakaṭana)	
advertising 	 ప్రకటనలు 	(Prakaṭanalu)	
advice 	 సలహా 	(Salahā)	
advise 	 సలహా ఇవ్వండి 	(Salahā ivvaṇḍi)	
affair 	 వ్యవహారం 	(Vyavahāraṁ)	
affect 	 ప్రభావితం చేస్తాయి 	(Prabhāvitaṁ cēstāyi)	
affection 	 ఆప్యాయత 	(Āpyāyata)	
afford 	 స్థోమత 	(Sthōmata)	
afraid 	 భయపడ్డాను 	(Bhayapaḍḍānu)	
after 	 తర్వాత 	(Tarvāta)	
afternoon 	 మధ్యాహ్నం 	(Madhyāhnaṁ)	
afterwards 	 తరువాత 	(Taruvāta)	
again 	 మళ్ళీ 	(Maḷḷī)	
against 	 వ్యతిరేకంగా 	(Vyatirēkaṅgā)	
age 	 వయస్సు 	(Vayas'su)	
aged 	 వృద్ధుడు 	(Vr̥d'dhuḍu)	
agency 	 ఏజెన్సీ 	(Ējensī)	
agent 	 ఏజెంట్ 	(Ējeṇṭ)	
aggressive 	 దూకుడు 	(Dūkuḍu)	
ago 	 క్రితం 	(Kritaṁ)	
agree 	 అంగీకరిస్తున్నారు 	(Aṅgīkaristunnāru)	
agreement 	 ఒప్పందం 	(Oppandaṁ)	
ahead 	 ముందుకు 	(Munduku)	
aid 	 సహాయం 	(Sahāyaṁ)	
aim 	 లక్ష్యం 	(Lakṣyaṁ)	
air 	 గాలి 	(Gāli)	
aircraft 	 విమానం 	(Vimānaṁ)	
airport 	 విమానాశ్రయం 	(Vimānāśrayaṁ)	
alarm 	 అలారం 	(Alāraṁ)	
alarmed 	 అప్రమత్తమయ్యారు 	(Apramattamayyāru)	
alarming 	 ఆందోళనకరమైన 	(Āndōḷanakaramaina)	
alcohol 	 మద్యం 	(Madyaṁ)	
alcoholic 	 మద్యపానం 	(Madyapānaṁ)	
alive 	 సజీవంగా 	(Sajīvaṅgā)	
all 	 అన్ని 	(Anni)	
allied 	 పొత్తు పెట్టుకుంది 	(Pottu peṭṭukundi)	
allow 	 అనుమతిస్తాయి 	(Anumatistāyi)	
allow for 	 అనుమతిస్తాయి 	(Anumatistāyi)	
all right 	 సరే 	(Sarē)	
ally 	 మిత్రుడు 	(Mitruḍu)	
almost 	 దాదాపు 	(Dādāpu)	
alone 	 ఒంటరిగా 	(Oṇṭarigā)	
along 	 పాటు 	(Pāṭu)	
alongside 	 పక్కన 	(Pakkana)	
aloud 	 బిగ్గరగా 	(Biggaragā)	
alphabet 	 వర్ణమాల 	(Varṇamāla)	
alphabetical 	 అక్షరక్రమం 	(Akṣarakramaṁ)	
alphabetically 	 అక్షరక్రమంలో 	(Akṣarakramanlō)	
already 	 ఇప్పటికే 	(Ippaṭikē)	
also 	 కూడా 	(Kūḍā)	
alter 	 మార్చు 	(Mārcu)	
alternative 	 ప్రత్యామ్నాయం 	(Pratyāmnāyaṁ)	
alternatively 	 ప్రత్యామ్నాయంగా 	(Pratyāmnāyaṅgā)	
although 	 అయినప్పటికీ 	(Ayinappaṭikī)	
altogether 	 పూర్తిగా 	(Pūrtigā)	
always 	 ఎల్లప్పుడూ 	(Ellappuḍū)	
a.m. 	 a.m. 	(A.M.)	
amaze 	 ఆశ్చర్యపరుస్తాయి 	(Āścaryaparustāyi)	
amazed 	 ఆశ్చర్యపోయాడు 	(Āścaryapōyāḍu)	
amazing 	 అద్భుతమైన 	(Adbhutamaina)	
ambition 	 ఆశయం 	(Āśayaṁ)	
ambulance 	 అంబులెన్స్ 	(Ambulens)	
among 	 మధ్య 	(Madhya)	
amount 	 మొత్తం 	(Mottaṁ)	
amount to 	 మొత్తం 	(Mottaṁ)	
amuse 	 వినోదం 	(Vinōdaṁ)	
amused 	 నవ్వించాడు 	(Navvin̄cāḍu)	
amusing 	 వినోదభరితమైన 	(Vinōdabharitamaina)	
analyse 	 విశ్లేషించండి 	(Viślēṣin̄caṇḍi)	
analysis 	 విశ్లేషణ 	(Viślēṣaṇa)	
ancient 	 పురాతనమైనది 	(Purātanamainadi)	
and 	 మరియు 	(Mariyu)	
anger 	 కోపం 	(Kōpaṁ)	
angle 	 కోణం 	(Kōṇaṁ)	
angrily 	 కోపంగా 	(Kōpaṅgā)	
angry 	 కోపంగా 	(Kōpaṅgā)	
animal 	 జంతువు 	(Jantuvu)	
ankle 	 చీలమండ 	(Cīlamaṇḍa)	
anniversary 	 వార్షికోత్సవం 	(Vārṣikōtsavaṁ)	
announce 	 ప్రకటించండి 	(Prakaṭin̄caṇḍi)	
annoy 	 బాధించు 	(Bādhin̄cu)	
annoyed 	 చిరాకుపడ్డాడు 	(Cirākupaḍḍāḍu)	
annoying 	 బాధించే 	(Bādhin̄cē)	
annual 	 వార్షిక 	(Vārṣika)	
annually 	 ఏటా 	(Ēṭā)	
another 	 మరొకటి 	(Marokaṭi)	
answer 	 సమాధానం 	(Samādhānaṁ)	
anti- 	 వ్యతిరేక 	(Vyatirēka)	
anticipate 	 ఎదురుచూడాలి 	(Edurucūḍāli)	
anxiety 	 ఆందోళన 	(Āndōḷana)	
anxious 	 ఆత్రుతగా 	(Ātrutagā)	
anxiously 	 ఆత్రుతగా 	(Ātrutagā)	
any 	 ఏదైనా 	(Ēdainā)	
anybody 	 ఎవరైనా 	(Evarainā)	
anyone 	 ఎవరైనా 	(Evarainā)	
anything 	 ఏదైనా 	(Ēdainā)	
anyway 	 ఏమైనప్పటికీ 	(Ēmainappaṭikī)	
anywhere 	 ఎక్కడైనా 	(Ekkaḍainā)	
apart 	 వేరుగా 	(Vērugā)	
apart from 	 కాకుండా 	(Kākuṇḍā)	
apartment 	 అపార్ట్మెంట్ 	(Apārṭmeṇṭ)	
apologize 	 క్షమాపణ చెప్పండి 	(Kṣamāpaṇa ceppaṇḍi)	
apparent 	 స్పష్టమైన 	(Spaṣṭamaina)	
apparently 	 స్పష్టంగా 	(Spaṣṭaṅgā)	
appeal 	 విజ్ఞప్తి 	(Vijñapti)	
appear 	 కనిపిస్తాయి 	(Kanipistāyi)	
appearance 	 ప్రదర్శన 	(Pradarśana)	
apple 	 ఆపిల్ 	(Āpil)	
application 	 అప్లికేషన్ 	(Aplikēṣan)	
apply 	 దరఖాస్తు 	(Darakhāstu)	
appoint 	 నియమిస్తారు 	(Niyamistāru)	
appointment 	 నియామకం 	(Niyāmakaṁ)	
appreciate 	 అభినందిస్తున్నాము 	(Abhinandistunnāmu)	
approach 	 విధానం 	(Vidhānaṁ)	
appropriate 	 తగిన 	(Tagina)	
approval 	 ఆమోదం 	(Āmōdaṁ)	
approve 	 ఆమోదించండి 	(Āmōdin̄caṇḍi)	
approving 	 ఆమోదించడం 	(Āmōdin̄caḍaṁ)	
approximate 	 సుమారుగా 	(Sumārugā)	
approximately 	 సుమారుగా 	(Sumārugā)	
April 	 ఏప్రిల్ 	(Ēpril)	
area 	 ప్రాంతం 	(Prāntaṁ)	
argue 	 వాదిస్తారు 	(Vādistāru)	
argument 	 వాదన 	(Vādana)	
arise 	 తలెత్తుతాయి 	(Talettutāyi)	
arm 	 చేయి 	(Cēyi)	
armed 	 సాయుధ 	(Sāyudha)	
arms 	 చేతులు 	(Cētulu)	
army 	 సైన్యం 	(Sain'yaṁ)	
around 	 చుట్టూ 	(Cuṭṭū)	
arrange 	 ఏర్పాట్లు 	(Ērpāṭlu)	
arrangement 	 అమరిక 	(Amarika)	
arrest 	 అరెస్టు 	(Aresṭu)	
arrival 	 రాక 	(Rāka)	
arrive 	 చేరుకుంటారు 	(Cērukuṇṭāru)	
arrive at 	 వద్దకు చేరుకుంటారు 	(Vaddaku cērukuṇṭāru)	
arrow 	 బాణం 	(Bāṇaṁ)	
art 	 కళ 	(Kaḷa)	
article 	 వ్యాసం 	(Vyāsaṁ)	
artificial 	 కృత్రిమ 	(Kr̥trima)	
artificially 	 కృత్రిమంగా 	(Kr̥trimaṅgā)	
artist 	 కళాకారుడు 	(Kaḷākāruḍu)	
artistic 	 కళాత్మకమైనది 	(Kaḷātmakamainadi)	
artistically 	 కళాత్మకంగా 	(Kaḷātmakaṅgā)	
as 	 వంటి 	(Vaṇṭi)	
ashamed 	 సిగ్గుపడ్డాడు 	(Siggupaḍḍāḍu)	
aside 	 ప్రక్కన 	(Prakkana)	
aside from 	 పక్కన 	(Pakkana)	
ask 	 అడగండి 	(Aḍagaṇḍi)	
asleep 	 నిద్రపోతున్నాను 	(Nidrapōtunnānu)	
aspect 	 అంశం 	(Anśaṁ)	
assist 	 సహాయం 	(Sahāyaṁ)	
assistance 	 సహాయం 	(Sahāyaṁ)	
assistant 	 సహాయకుడు 	(Sahāyakuḍu)	
associate 	 సహచరుడు 	(Sahacaruḍu)	
associated 	 అనుబంధించబడింది 	(Anubandhin̄cabaḍindi)	
association 	 సంఘం 	(Saṅghaṁ)	
assume 	 ఊహిస్తారు 	(Ūhistāru)	
assure 	 భరోసా 	(Bharōsā)	
at 	 వద్ద 	(Vadda)	
atmosphere 	 వాతావరణం 	(Vātāvaraṇaṁ)	
atom 	 పరమాణువు 	(Paramāṇuvu)	
attach 	 అటాచ్ చేయండి 	(Aṭāc cēyaṇḍi)	
attached 	 జోడించబడింది 	(Jōḍin̄cabaḍindi)	
attack 	 దాడి 	(Dāḍi)	
attempt 	 ప్రయత్నం 	(Prayatnaṁ)	
attempted 	 ప్రయత్నించాడు 	(Prayatnin̄cāḍu)	
attend 	 హాజరు 	(Hājaru)	
attend to 	 హాజరు 	(Hājaru)	
attention 	 శ్రద్ధ 	(Śrad'dha)	
attitude 	 వైఖరి 	(Vaikhari)	
attorney 	 న్యాయవాది 	(N'yāyavādi)	
attract 	 ఆకర్షిస్తాయి 	(Ākarṣistāyi)	
attraction 	 ఆకర్షణ 	(Ākarṣaṇa)	
attractive 	 ఆకర్షణీయమైన 	(Ākarṣaṇīyamaina)	
audience 	 ప్రేక్షకులు 	(Prēkṣakulu)	
August 	 ఆగస్టు 	(Āgasṭu)	
aunt 	 అత్త 	(Atta)	
author 	 రచయిత 	(Racayita)	
authority 	 అధికారం 	(Adhikāraṁ)	
automatic 	 ఆటోమేటిక్ 	(Āṭōmēṭik)	
automatically 	 స్వయంచాలకంగా 	(Svayan̄cālakaṅgā)	
autumn 	 శరదృతువు 	(Śaradr̥tuvu)	
available 	 అందుబాటులో 	(Andubāṭulō)	
average 	 సగటు 	(Sagaṭu)	
avoid 	 నివారించండి 	(Nivārin̄caṇḍi)	
awake 	 మేల్కొని 	(Mēlkoni)	
award 	 అవార్డు 	(Avārḍu)	
aware 	 తెలుసు 	(Telusu)	
away 	 దూరంగా 	(Dūraṅgā)	
awful 	 భయంకరం 	(Bhayaṅkaraṁ)	
awfully 	 భయంకరంగా 	(Bhayaṅkaraṅgā)	
awkward 	 ఇబ్బందికరమైన 	(Ibbandikaramaina)	
awkwardly 	 వికారంగా 	(Vikāraṅgā)	
baby 	 శిశువు 	(Śiśuvu)	
back 	 తిరిగి 	(Tirigi)	
background 	 నేపథ్యం 	(Nēpathyaṁ)	
back up 	 బ్యాకప్ 	(Byākap)	
backward 	 వెనుకబడిన 	(Venukabaḍina)	
backwards 	 వెనుకకు 	(Venukaku)	
bacteria 	 బాక్టీరియా 	(Bākṭīriyā)	
bad 	 చెడు 	(Ceḍu)	
badly 	 చెడుగా 	(Ceḍugā)	
bad-tempered 	 చెడు స్వభావం కలవాడు 	(Ceḍu svabhāvaṁ kalavāḍu)	
bag 	 సంచి 	(San̄ci)	
baggage 	 సామాను 	(Sāmānu)	
bake 	 కాల్చండి 	(Kālcaṇḍi)	
balance 	 సంతులనం 	(Santulanaṁ)	
ball 	 బంతి 	(Banti)	
ban 	 నిషేధించండి 	(Niṣēdhin̄caṇḍi)	
band 	 బ్యాండ్ 	(Byāṇḍ)	
bandage 	 కట్టు 	(Kaṭṭu)	
bank 	 బ్యాంకు 	(Byāṅku)	
bar 	 బార్ 	(Bār)	
bargain 	 బేరం 	(Bēraṁ)	
barrier 	 అడ్డంకి 	(Aḍḍaṅki)	
base 	 బేస్ 	(Bēs)	
based 	 ఆధారంగా 	(Ādhāraṅgā)	
base on 	 ఆధారంగా 	(Ādhāraṅgā)	
basic 	 ప్రాథమిక 	(Prāthamika)	
basically 	 ప్రాథమికంగా 	(Prāthamikaṅgā)	
basis 	 ఆధారంగా 	(Ādhāraṅgā)	
bath 	 స్నానం 	(Snānaṁ)	
bathroom 	 బాత్రూమ్ 	(Bātrūm)	
battery 	 బ్యాటరీ 	(Byāṭarī)	
battle 	 యుద్ధం 	(Yud'dhaṁ)	
bay 	 బే 	(Bē)	
be 	 ఉంటుంది 	(Uṇṭundi)	
beach 	 బీచ్ 	(Bīc)	
beak 	 ముక్కు 	(Mukku)	
bear 	 ఎలుగుబంటి 	(Elugubaṇṭi)	
beard 	 గడ్డం 	(Gaḍḍaṁ)	
beat 	 కొట్టారు 	(Koṭṭāru)	
beat up 	 కొట్టారు 	(Koṭṭāru)	
beautiful 	 అందమైన 	(Andamaina)	
beautifully 	 అందంగా 	(Andaṅgā)	
beauty 	 అందం 	(Andaṁ)	
because 	 ఎందుకంటే 	(Endukaṇṭē)	
because of 	 ఎందుకంటే 	(Endukaṇṭē)	
become 	 అవుతాయి 	(Avutāyi)	
bed 	 మంచం 	(Man̄caṁ)	
bedroom 	 పడకగది 	(Paḍakagadi)	
beef 	 గొడ్డు మాంసం 	(Goḍḍu mānsaṁ)	
beer 	 బీరు 	(Bīru)	
before 	 ముందు 	(Mundu)	
begin 	 ప్రారంభం 	(Prārambhaṁ)	
beginning 	 ప్రారంభం 	(Prārambhaṁ)	
behalf 	 తరపున 	(Tarapuna)	
behave 	 ప్రవర్తిస్తారు 	(Pravartistāru)	
behaviour 	 ప్రవర్తన 	(Pravartana)	
behind 	 వెనుక 	(Venuka)	
be left over 	 మిగులుతుంది 	(Migulutundi)	
belief 	 నమ్మకం 	(Nam'makaṁ)	
believe 	 నమ్మకం 	(Nam'makaṁ)	
believe in 	 నమ్మకం 	(Nam'makaṁ)	
bell 	 గంట 	(Gaṇṭa)	
belong 	 చెందినవి 	(Cendinavi)	
belong to 	 చెందినవి 	(Cendinavi)	
below 	 క్రింద 	(Krinda)	
belt 	 బెల్ట్ 	(Belṭ)	
bend 	 వంచు 	(Van̄cu)	
beneath 	 కింద 	(Kinda)	
benefit 	 ప్రయోజనం 	(Prayōjanaṁ)	
bent 	 వంగి 	(Vaṅgi)	
beside 	 పక్కన 	(Pakkana)	
best 	 ఉత్తమమైనది 	(Uttamamainadi)	
bet 	 పందెం 	(Pandeṁ)	
better 	 మెరుగైన 	(Merugaina)	
betting 	 బెట్టింగ్ 	(Beṭṭiṅg)	
between 	 మధ్య 	(Madhya)	
beyond 	 దాటి 	(Dāṭi)	
bicycle 	 సైకిల్ 	(Saikil)	
bid 1 	 వేలం 1 	(Vēlaṁ 1)	
big 	 పెద్ద 	(Pedda)	
bike 	 బైక్ 	(Baik)	
bill 	 బిల్లు 	(Billu)	
billion 	 బిలియన్ 	(Biliyan)	
bin 	 డబ్బా 	(Ḍabbā)	
biology 	 జీవశాస్త్రం 	(Jīvaśāstraṁ)	
bird 	 పక్షి 	(Pakṣi)	
birth 	 పుట్టుక 	(Puṭṭuka)	
birthday 	 పుట్టినరోజు 	(Puṭṭinarōju)	
biscuit 	 బిస్కెట్ 	(Biskeṭ)	
bit 	 బిట్ 	(Biṭ)	
bite 	 కొరుకు 	(Koruku)	
bitter 	 చేదు 	(Cēdu)	
bitterly 	 చేదుగా 	(Cēdugā)	
black 	 నలుపు 	(Nalupu)	
blade 	 బ్లేడ్ 	(Blēḍ)	
blame 	 నిందిస్తారు 	(Nindistāru)	
blank 	 ఖాళీ 	(Khāḷī)	
blind 	 అంధుడు 	(Andhuḍu)	
block 	 నిరోధించు 	(Nirōdhin̄cu)	
blonde 	 అందగత్తె 	(Andagatte)	
blood 	 రక్తం 	(Raktaṁ)	
blow 	 దెబ్బ 	(Debba)	
blow out 	 బయటకు ఊదండి 	(Bayaṭaku ūdaṇḍi)	
blow up 	 పేల్చివేయు 	(Pēlcivēyu)	
blue 	 నీలం 	(Nīlaṁ)	
board 	 బోర్డు 	(Bōrḍu)	
boat 	 పడవ 	(Paḍava)	
body 	 శరీరం 	(Śarīraṁ)	
boil 	 ఉడకబెట్టండి 	(Uḍakabeṭṭaṇḍi)	
bomb 	 బాంబు 	(Bāmbu)	
bone 	 ఎముక 	(Emuka)	
book 	 పుస్తకం 	(Pustakaṁ)	
boot 	 బూట్ 	(Būṭ)	
border 	 సరిహద్దు 	(Sarihaddu)	
bore 	 బోర్ కొట్టింది 	(Bōr koṭṭindi)	
bored 	 నీరసం 	(Nīrasaṁ)	
boring 	 నీరసం 	(Nīrasaṁ)	
born 	 పుట్టింది 	(Puṭṭindi)	
borrow 	 అప్పు తీసుకుంటారు 	(Appu tīsukuṇṭāru)	
boss 	 బాస్ 	(Bās)	
both 	 రెండూ 	(Reṇḍū)	
bother 	 ఇబ్బంది పెడతారు 	(Ibbandi peḍatāru)	
bottle 	 సీసా 	(Sīsā)	
bottom 	 దిగువన 	(Diguvana)	
bound 	 కట్టుబడి 	(Kaṭṭubaḍi)	
bowl 	 గిన్నె 	(Ginne)	
box 	 పెట్టె 	(Peṭṭe)	
boy 	 అబ్బాయి 	(Abbāyi)	
boyfriend 	 ప్రియుడు 	(Priyuḍu)	
brain 	 మెదడు 	(Medaḍu)	
branch 	 శాఖ 	(Śākha)	
brand 	 బ్రాండ్ 	(Brāṇḍ)	
brave 	 ధైర్యవంతుడు 	(Dhairyavantuḍu)	
bread 	 రొట్టె 	(Roṭṭe)	
break 	 బ్రేక్ 	(Brēk)	
break down 	 విచ్ఛిన్నం 	(Vicchinnaṁ)	
breakfast 	 అల్పాహారం 	(Alpāhāraṁ)	
break in 	 లోపలికి ప్రవేశించండి 	(Lōpaliki pravēśin̄caṇḍi)	
break into 	 ప్రవేశించండి 	(Pravēśin̄caṇḍi)	
break off 	 విడిపోతాయి 	(Viḍipōtāyi)	
break out 	 విరుచుకుపడతాయి 	(Virucukupaḍatāyi)	
break up 	 విడిపోతారు 	(Viḍipōtāru)	
breast 	 రొమ్ము 	(Rom'mu)	
breath 	 శ్వాస 	(Śvāsa)	
breathe 	 ఊపిరి పీల్చుకుంటారు 	(Ūpiri pīlcukuṇṭāru)	
breathe in 	 ఊపిరి పీల్చుకోండి 	(Ūpiri pīlcukōṇḍi)	
breathe out 	 ఊపిరి పీల్చుకోండి 	(Ūpiri pīlcukōṇḍi)	
breathing 	 శ్వాస 	(Śvāsa)	
breed 	 జాతి 	(Jāti)	
brick 	 ఇటుక 	(Iṭuka)	
bridge 	 వంతెన 	(Vantena)	
brief 	 క్లుప్తంగా 	(Kluptaṅgā)	
briefly 	 క్లుప్తంగా 	(Kluptaṅgā)	
bright 	 ప్రకాశవంతమైన 	(Prakāśavantamaina)	
brightly 	 ప్రకాశవంతంగా 	(Prakāśavantaṅgā)	
brilliant 	 తెలివైన 	(Telivaina)	
bring 	 తీసుకురండి 	(Tīsukuraṇḍi)	
bring back 	 తిరిగి తీసుకురండి 	(Tirigi tīsukuraṇḍi)	
bring down 	 దించు 	(Din̄cu)	
bring forward 	 ముందుకు తీసుకురండి 	(Munduku tīsukuraṇḍi)	
bring out 	 బయటకు తీసుకురండి 	(Bayaṭaku tīsukuraṇḍi)	
bring up 	 తీసుకురండి 	(Tīsukuraṇḍi)	
broad 	 విశాలమైనది 	(Viśālamainadi)	
broadcast 	 ప్రసారం 	(Prasāraṁ)	
broadly 	 విస్తృతంగా 	(Vistr̥taṅgā)	
broken 	 విరిగిపోయింది 	(Virigipōyindi)	
brother 	 సోదరుడు 	(Sōdaruḍu)	
brown 	 గోధుమ రంగు 	(Gōdhuma raṅgu)	
brush 	 బ్రష్ 	(Braṣ)	
bubble 	 బుడగ 	(Buḍaga)	
budget 	 బడ్జెట్ 	(Baḍjeṭ)	
build 	 నిర్మించు 	(Nirmin̄cu)	
building 	 భవనం 	(Bhavanaṁ)	
build up 	 నిర్మించడానికి 	(Nirmin̄caḍāniki)	
bullet 	 బుల్లెట్ 	(Bulleṭ)	
bunch 	 బంచ్ 	(Ban̄c)	
burn 	 కాల్చండి 	(Kālcaṇḍi)	
burn down 	 కాల్చివేయుము 	(Kālcivēyumu)	
burnt 	 కాలింది 	(Kālindi)	
burst 	 పగిలిపోతుంది 	(Pagilipōtundi)	
burst into 	 లోకి దూసుకుపోయింది 	(Lōki dūsukupōyindi)	
burst out 	 పగిలిపోయింది 	(Pagilipōyindi)	
bury 	 పాతిపెట్టు 	(Pātipeṭṭu)	
bus 	 బస్సు 	(Bas'su)	
bush 	 పొద 	(Poda)	
business 	 వ్యాపారం 	(Vyāpāraṁ)	
businessman 	 వ్యాపారవేత్త 	(Vyāpāravētta)	
busy 	 బిజీగా ఉన్నారు 	(Bijīgā unnāru)	
but 	 కాని 	(Kāni)	
butter 	 వెన్న 	(Venna)	
button 	 బటన్ 	(Baṭan)	
buy 	 కొనండి 	(Konaṇḍi)	
buyer 	 కొనుగోలుదారు 	(Konugōludāru)	
by 	 ద్వారా 	(Dvārā)	
bye 	 బై 	(Bai)	
cabinet 	 మంత్రివర్గం 	(Mantrivargaṁ)	
cable 	 కేబుల్ 	(Kēbul)	
cake 	 కేక్ 	(Kēk)	
calculate 	 లెక్కించు 	(Lekkin̄cu)	
calculation 	 గణన 	(Gaṇana)	
call 	 కాల్ చేయండి 	(Kāl cēyaṇḍi)	
call back 	 తిరిగి కాల్ చేయండి 	(Tirigi kāl cēyaṇḍi)	
called 	 అని పిలిచారు 	(Ani pilicāru)	
call for 	 కోసం కాల్ 	(Kōsaṁ kāl)	
call off 	 కాల్ ఆఫ్ 	(Kāl āph)	
call up 	 కాల్ చేయండి 	(Kāl cēyaṇḍi)	
calm 	 ప్రశాంతత 	(Praśāntata)	
calm down 	 శాంతించండి 	(Śāntin̄caṇḍi)	
calmly 	 ప్రశాంతంగా 	(Praśāntaṅgā)	
camera 	 కెమెరా 	(Kemerā)	
camp 	 శిబిరం 	(Śibiraṁ)	
campaign 	 ప్రచారం 	(Pracāraṁ)	
camping 	 క్యాంపింగ్ 	(Kyāmpiṅg)	
can 1 	 చెయ్యవచ్చు 1 	(Ceyyavaccu 1)	
can 2 	 చెయ్యవచ్చు 2 	(Ceyyavaccu 2)	
cancel 	 రద్దు 	(Raddu)	
cancer 	 క్యాన్సర్ 	(Kyānsar)	
candidate 	 అభ్యర్థి 	(Abhyarthi)	
candy 	 మిఠాయి 	(Miṭhāyi)	
cannot 	 కుదరదు 	(Kudaradu)	
cap 	 టోపీ 	(Ṭōpī)	
capable 	 సమర్థుడు 	(Samarthuḍu)	
capacity 	 సామర్థ్యం 	(Sāmarthyaṁ)	
capital 	 రాజధాని 	(Rājadhāni)	
captain 	 కెప్టెన్ 	(Kepṭen)	
capture 	 పట్టుకోవడం 	(Paṭṭukōvaḍaṁ)	
car 	 కారు 	(Kāru)	
card 	 కార్డు 	(Kārḍu)	
cardboard 	 కార్డ్బోర్డ్ 	(Kārḍbōrḍ)	
care 	 శ్రమ 	(Śrama)	
career 	 వృత్తి 	(Vr̥tti)	
care for 	 శ్రమ 	(Śrama)	
careful 	 జాగ్రత్తగా 	(Jāgrattagā)	
carefully 	 జాగ్రత్తగా 	(Jāgrattagā)	
careless 	 అజాగ్రత్త 	(Ajāgratta)	
carelessly 	 నిర్లక్ష్యంగా 	(Nirlakṣyaṅgā)	
carpet 	 కార్పెట్ 	(Kārpeṭ)	
carrot 	 క్యారెట్ 	(Kyāreṭ)	
carry 	 తీసుకువెళ్ళండి 	(Tīsukuveḷḷaṇḍi)	
carry on 	 కొనసాగించు 	(Konasāgin̄cu)	
carry out 	 చేపడతారు 	(Cēpaḍatāru)	
case 	 కేసు 	(Kēsu)	
cash 	 నగదు 	(Nagadu)	
cast 	 తారాగణం 	(Tārāgaṇaṁ)	
castle 	 కోట 	(Kōṭa)	
cat 	 పిల్లి 	(Pilli)	
catch 	 క్యాచ్ 	(Kyāc)	
catch up 	 పట్టుకోండి 	(Paṭṭukōṇḍi)	
category 	 వర్గం 	(Vargaṁ)	
cause 	 కారణం 	(Kāraṇaṁ)	
CD 	 CD 	(CD)	
cease 	 నిలిపివేయండి 	(Nilipivēyaṇḍi)	
ceiling 	 పైకప్పు 	(Paikappu)	
celebrate 	 జరుపుకుంటారు 	(Jarupukuṇṭāru)	
celebration 	 వేడుక 	(Vēḍuka)	
cell 	 సెల్ 	(Sel)	
cell phone 	 సెల్ ఫోన్ 	(Sel phōn)	
cent 	 సెంటు 	(Seṇṭu)	
centimetre 	 సెంటీమీటర్ 	(Seṇṭīmīṭar)	
central 	 కేంద్ర 	(Kēndra)	
centre 	 కేంద్రం 	(Kēndraṁ)	
century 	 శతాబ్దం 	(Śatābdaṁ)	
ceremony 	 వేడుక 	(Vēḍuka)	
certain 	 ఖచ్చితంగా 	(Khaccitaṅgā)	
certainly 	 ఖచ్చితంగా 	(Khaccitaṅgā)	
certificate 	 సర్టిఫికేట్ 	(Sarṭiphikēṭ)	
chain 	 గొలుసు 	(Golusu)	
chair 	 కుర్చీ 	(Kurcī)	
chairman 	 చైర్మన్ 	(Cairman)	
chairwoman 	 అధ్యక్షురాలు 	(Adhyakṣurālu)	
challenge 	 సవాలు 	(Savālu)	
chamber 	 గది 	(Gadi)	
chance 	 అవకాశం 	(Avakāśaṁ)	
change 	 మార్పు 	(Mārpu)	
change round 	 రౌండ్ మార్చండి 	(Rauṇḍ mārcaṇḍi)	
channel 	 ఛానెల్ 	(Chānel)	
chapter 	 అధ్యాయం 	(Adhyāyaṁ)	
character 	 పాత్ర 	(Pātra)	
characteristic 	 లక్షణం 	(Lakṣaṇaṁ)	
charge 	 వసూలు 	(Vasūlu)	
charity 	 దాతృత్వం 	(Dātr̥tvaṁ)	
chart 	 చార్ట్ 	(Cārṭ)	
chase 	 వెంబడించు 	(Vembaḍin̄cu)	
chase away 	 తరిమికొట్టండి 	(Tarimikoṭṭaṇḍi)	
chat 	 చాట్ 	(Cāṭ)	
cheap 	 చౌక 	(Cauka)	
cheaply 	 చౌకగా 	(Caukagā)	
cheat 	 మోసం 	(Mōsaṁ)	
cheat of 	 మోసం 	(Mōsaṁ)	
check 	 తనిఖీ 	(Tanikhī)	
check in 	 చెక్ ఇన్ 	(Cek in)	
check into 	 తనిఖీ 	(Tanikhī)	
check on 	 తనిఖీ చేయండి 	(Tanikhī cēyaṇḍi)	
check out 	 తనిఖీ చేయండి 	(Tanikhī cēyaṇḍi)	
check over 	 తనిఖీ చేయండి 	(Tanikhī cēyaṇḍi)	
check up on 	 తనిఖీ 	(Tanikhī)	
cheek 	 చెంప 	(Cempa)	
cheerful 	 ఉల్లాసంగా 	(Ullāsaṅgā)	
cheerfully 	 ఉల్లాసంగా 	(Ullāsaṅgā)	
cheese 	 జున్ను 	(Junnu)	
chemical 	 రసాయన 	(Rasāyana)	
chemist 	 రసాయన శాస్త్రవేత్త 	(Rasāyana śāstravētta)	
chemistry 	 రసాయన శాస్త్రం 	(Rasāyana śāstraṁ)	
cheque 	 తనిఖీ 	(Tanikhī)	
chest 	 ఛాతీ 	(Chātī)	
chew 	 నమలండి 	(Namalaṇḍi)	
chicken 	 చికెన్ 	(Ciken)	
chief 	 అధినేత 	(Adhinēta)	
child 	 బిడ్డ 	(Biḍḍa)	
chin 	 గడ్డం 	(Gaḍḍaṁ)	
chip 	 చిప్ 	(Cip)	
chocolate 	 చాక్లెట్ 	(Cākleṭ)	
choice 	 ఎంపిక 	(Empika)	
choose 	 ఎంచుకోండి 	(En̄cukōṇḍi)	
chop 	 గొడ్డలితో నరకడం 	(Goḍḍalitō narakaḍaṁ)	
chop down 	 గొడ్డలితో నరకడం 	(Goḍḍalitō narakaḍaṁ)	
chop off 	 గొడ్డలితో నరకడం 	(Goḍḍalitō narakaḍaṁ)	
church 	 చర్చి 	(Carci)	
cigarette 	 సిగరెట్ 	(Sigareṭ)	
cinema 	 సినిమా 	(Sinimā)	
circle 	 సర్కిల్ 	(Sarkil)	
circumstance 	 పరిస్థితి 	(Paristhiti)	
citizen 	 పౌరుడు 	(Pauruḍu)	
city 	 నగరం 	(Nagaraṁ)	
civil 	 పౌర 	(Paura)	
claim 	 దావా 	(Dāvā)	
clap 	 చప్పట్లు కొట్టండి 	(Cappaṭlu koṭṭaṇḍi)	
class 	 తరగతి 	(Taragati)	
classic 	 క్లాసిక్ 	(Klāsik)	
classroom 	 తరగతి గది 	(Taragati gadi)	
clean 	 శుభ్రంగా 	(Śubhraṅgā)	
clean up 	 శుభ్రం 	(Śubhraṁ)	
clear 	 స్పష్టమైన 	(Spaṣṭamaina)	
clearly 	 స్పష్టంగా 	(Spaṣṭaṅgā)	
clear out 	 క్లియర్ అవుట్ 	(Kliyar avuṭ)	
clear up 	 క్లియర్ చేయండి 	(Kliyar cēyaṇḍi)	
clerk 	 గుమాస్తా 	(Gumāstā)	
clever 	 తెలివైన 	(Telivaina)	
click 	 క్లిక్ చేయండి 	(Klik cēyaṇḍi)	
client 	 క్లయింట్ 	(Klayiṇṭ)	
climate 	 వాతావరణం 	(Vātāvaraṇaṁ)	
climb 	 ఎక్కండి 	(Ekkaṇḍi)	
climbing 	 ఎక్కడం 	(Ekkaḍaṁ)	
clock 	 గడియారం 	(Gaḍiyāraṁ)	
close 1 	 మూసివేయి 1 	(Mūsivēyi 1)	
close 2 	 దగ్గరగా 2 	(Daggaragā 2)	
closed 	 మూసివేయబడింది 	(Mūsivēyabaḍindi)	
closely 	 దగ్గరగా 	(Daggaragā)	
closet 	 గది 	(Gadi)	
cloth 	 గుడ్డ 	(Guḍḍa)	
clothes 	 బట్టలు 	(Baṭṭalu)	
clothing 	 దుస్తులు 	(Dustulu)	
cloud 	 మేఘం 	(Mēghaṁ)	
club 	 క్లబ్ 	(Klab)	
coach 	 కోచ్ 	(Kōc)	
coal 	 బొగ్గు 	(Boggu)	
coast 	 తీరం 	(Tīraṁ)	
coat 	 కోటు 	(Kōṭu)	
code 	 కోడ్ 	(Kōḍ)	
coffee 	 కాఫీ 	(Kāphī)	
coin 	 నాణెం 	(Nāṇeṁ)	
cold 	 చల్లని 	(Callani)	
coldly 	 చల్లగా 	(Callagā)	
collapse 	 కూలిపోతుంది 	(Kūlipōtundi)	
colleague 	 సహోద్యోగి 	(Sahōdyōgi)	
collect 	 సేకరించండి 	(Sēkarin̄caṇḍi)	
collection 	 సేకరణ 	(Sēkaraṇa)	
college 	 కళాశాల 	(Kaḷāśāla)	
colour 	 రంగు 	(Raṅgu)	
coloured 	 రంగులద్దిన 	(Raṅguladdina)	
column 	 కాలమ్ 	(Kālam)	
combination 	 కలయిక 	(Kalayika)	
combine 	 కలపండి 	(Kalapaṇḍi)	
come 	 వస్తాయి 	(Vastāyi)	
come across 	 అంతటా వస్తాయి 	(Antaṭā vastāyi)	
come down 	 క్రిందికి రండి 	(Krindiki raṇḍi)	
comedy 	 హాస్యం 	(Hāsyaṁ)	
come from 	 నుండి వస్తాయి 	(Nuṇḍi vastāyi)	
come in 	 లోపలికి రండి 	(Lōpaliki raṇḍi)	
come off 	 బయటకు వస్తాయి 	(Bayaṭaku vastāyi)	
come on 	 రండి 	(Raṇḍi)	
come out 	 బయటకు వస్తాయి 	(Bayaṭaku vastāyi)	
come round 	 చుట్టూ రండి 	(Cuṭṭū raṇḍi)	
come to 	 కు వస్తాయి 	(Ku vastāyi)	
come up 	 పైకి వస్తాయి 	(Paiki vastāyi)	
come up to 	 వరకు వస్తాయి 	(Varaku vastāyi)	
comfort 	 సౌకర్యం 	(Saukaryaṁ)	
comfortable 	 సౌకర్యవంతమైన 	(Saukaryavantamaina)	
comfortably 	 హాయిగా 	(Hāyigā)	
command 	 ఆదేశం 	(Ādēśaṁ)	
comment 	 వ్యాఖ్యానించండి 	(Vyākhyānin̄caṇḍi)	
commercial 	 వాణిజ్య 	(Vāṇijya)	
commission 	 కమిషన్ 	(Kamiṣan)	
commit 	 కట్టుబడి 	(Kaṭṭubaḍi)	
commitment 	 నిబద్ధత 	(Nibad'dhata)	
committee 	 కమిటీ 	(Kamiṭī)	
common 	 సాధారణ 	(Sādhāraṇa)	
commonly 	 సాధారణంగా 	(Sādhāraṇaṅgā)	
communicate 	 సంభాషించండి 	(Sambhāṣin̄caṇḍi)	
communication 	 కమ్యూనికేషన్ 	(Kamyūnikēṣan)	
community 	 సంఘం 	(Saṅghaṁ)	
company 	 సంస్థ 	(Sanstha)	
compare 	 సరిపోల్చండి 	(Saripōlcaṇḍi)	
comparison 	 పోలిక 	(Pōlika)	
compete 	 పోటీ చేస్తారు 	(Pōṭī cēstāru)	
competition 	 పోటీ 	(Pōṭī)	
competitive 	 పోటీ 	(Pōṭī)	
complain 	 ఫిర్యాదు 	(Phiryādu)	
complaint 	 ఫిర్యాదు 	(Phiryādu)	
complete 	 పూర్తి 	(Pūrti)	
completely 	 పూర్తిగా 	(Pūrtigā)	
complex 	 క్లిష్టమైన 	(Kliṣṭamaina)	
complicate 	 క్లిష్టతరం చేస్తాయి 	(Kliṣṭataraṁ cēstāyi)	
complicated 	 సంక్లిష్టమైనది 	(Saṅkliṣṭamainadi)	
computer 	 కంప్యూటర్ 	(Kampyūṭar)	
concentrate 	 ఏకాగ్రత 	(Ēkāgrata)	
concentrate on 	 ఏకాగ్రత 	(Ēkāgrata)	
concentration 	 ఏకాగ్రత 	(Ēkāgrata)	
concept 	 భావన 	(Bhāvana)	
concern 	 ఆందోళన 	(Āndōḷana)	
concerned 	 ఆందోళన చెందింది 	(Āndōḷana cendindi)	
concerning 	 సంబంధించిన 	(Sambandhin̄cina)	
concert 	 కచేరీ 	(Kacērī)	
conclude 	 ముగించారు 	(Mugin̄cāru)	
conclusion 	 ముగింపు 	(Mugimpu)	
concrete 	 కాంక్రీటు 	(Kāṅkrīṭu)	
condition 	 పరిస్థితి 	(Paristhiti)	
conduct 	 ప్రవర్తన 	(Pravartana)	
conference 	 సమావేశం 	(Samāvēśaṁ)	
confidence 	 విశ్వాసం 	(Viśvāsaṁ)	
confident 	 నమ్మకంగా 	(Nam'makaṅgā)	
confidently 	 నమ్మకంగా 	(Nam'makaṅgā)	
confine 	 నిర్బంధించండి 	(Nirbandhin̄caṇḍi)	
confined 	 పరిమితమైంది 	(Parimitamaindi)	
confirm 	 నిర్ధారించండి 	(Nirdhārin̄caṇḍi)	
conflict 	 సంఘర్షణ 	(Saṅgharṣaṇa)	
confront 	 ఎదుర్కొంటారు 	(Edurkoṇṭāru)	
confuse 	 గందరగోళం 	(Gandaragōḷaṁ)	
confused 	 అయోమయంలో పడ్డాడు 	(Ayōmayanlō paḍḍāḍu)	
confusing 	 గందరగోళంగా 	(Gandaragōḷaṅgā)	
confusion 	 గందరగోళం 	(Gandaragōḷaṁ)	
congratulate 	 అభినందనలు 	(Abhinandanalu)	
congratulation 	 అభినందనలు 	(Abhinandanalu)	
congress 	 కాంగ్రెస్ 	(Kāṅgres)	
connect 	 కనెక్ట్ చేయండి 	(Kanekṭ cēyaṇḍi)	
connected 	 కనెక్ట్ చేయబడింది 	(Kanekṭ cēyabaḍindi)	
connection 	 కనెక్షన్ 	(Kanekṣan)	
conscious 	 చేతనైన 	(Cētanaina)	
consequence 	 పర్యవసానంగా 	(Paryavasānaṅgā)	
conservative 	 సంప్రదాయవాది 	(Sampradāyavādi)	
consider 	 పరిగణించండి 	(Parigaṇin̄caṇḍi)	
considerable 	 గణనీయమైన 	(Gaṇanīyamaina)	
considerably 	 గణనీయంగా 	(Gaṇanīyaṅgā)	
consideration 	 పరిశీలన 	(Pariśīlana)	
consist 	 కలిగి ఉంటాయి 	(Kaligi uṇṭāyi)	
consist of 	 కలిగి ఉంటాయి 	(Kaligi uṇṭāyi)	
constant 	 స్థిరమైన 	(Sthiramaina)	
constantly 	 నిరంతరం 	(Nirantaraṁ)	
construct 	 నిర్మించు 	(Nirmin̄cu)	
construction 	 నిర్మాణం 	(Nirmāṇaṁ)	
consult 	 సంప్రదించండి 	(Sampradin̄caṇḍi)	
consumer 	 వినియోగదారుడు 	(Viniyōgadāruḍu)	
contact 	 సంప్రదించండి 	(Sampradin̄caṇḍi)	
contain 	 కలిగి ఉంటాయి 	(Kaligi uṇṭāyi)	
container 	 కంటైనర్ 	(Kaṇṭainar)	
contemporary 	 సమకాలీన 	(Samakālīna)	
content 1 	 కంటెంట్ 1 	(Kaṇṭeṇṭ 1)	
contest 	 పోటీ 	(Pōṭī)	
context 	 సందర్భం 	(Sandarbhaṁ)	
continent 	 ఖండం 	(Khaṇḍaṁ)	
continue 	 కొనసాగుతుంది 	(Konasāgutundi)	
continuous 	 నిరంతర 	(Nirantara)	
continuously 	 నిరంతరం 	(Nirantaraṁ)	
contract 	 ఒప్పందం 	(Oppandaṁ)	
contrast 	 విరుద్ధంగా 	(Virud'dhaṅgā)	
contrasting 	 విరుద్ధంగా 	(Virud'dhaṅgā)	
contribute 	 సహకరించండి 	(Sahakarin̄caṇḍi)	
contribution 	 సహకారం 	(Sahakāraṁ)	
control 	 నియంత్రణ 	(Niyantraṇa)	
controlled 	 నియంత్రించబడింది 	(Niyantrin̄cabaḍindi)	
convenient 	 అనుకూలమైనది 	(Anukūlamainadi)	
convention 	 సమావేశం 	(Samāvēśaṁ)	
conventional 	 సంప్రదాయ 	(Sampradāya)	
conversation 	 సంభాషణ 	(Sambhāṣaṇa)	
convert 	 మార్చు 	(Mārcu)	
convince 	 ఒప్పించండి 	(Oppin̄caṇḍi)	
cook 	 ఉడికించాలి 	(Uḍikin̄cāli)	
cooker 	 కుక్కర్ 	(Kukkar)	
cookie 	 కుక్కీ 	(Kukkī)	
cooking 	 వంట 	(Vaṇṭa)	
cool 	 చల్లని 	(Callani)	
cool down 	 చల్లబరుస్తుంది 	(Callabarustundi)	
cope 	 భరించవలసి ఉంటుంది 	(Bharin̄cavalasi uṇṭundi)	
copy 	 కాపీ 	(Kāpī)	
core 	 కోర్ 	(Kōr)	
corner 	 మూలలో 	(Mūlalō)	
correct 	 సరైనది 	(Sarainadi)	
correctly 	 సరిగ్గా 	(Sariggā)	
cost 	 ఖర్చు 	(Kharcu)	
cottage 	 కుటీర 	(Kuṭīra)	
cotton 	 పత్తి 	(Patti)	
cough 	 దగ్గు 	(Daggu)	
coughing 	 దగ్గు 	(Daggu)	
could 	 కాలేదు 	(Kālēdu)	
council 	 కౌన్సిల్ 	(Kaunsil)	
count 	 లెక్కించండి 	(Lekkin̄caṇḍi)	
counter 	 కౌంటర్ 	(Kauṇṭar)	
count on 	 లెక్కించు 	(Lekkin̄cu)	
country 	 దేశం 	(Dēśaṁ)	
countryside 	 పల్లెటూరు 	(Palleṭūru)	
county 	 కౌంటీ 	(Kauṇṭī)	
couple 	 జంట 	(Jaṇṭa)	
courage 	 ధైర్యం 	(Dhairyaṁ)	
course 	 కోర్సు 	(Kōrsu)	
court 	 కోర్టు 	(Kōrṭu)	
cousin 	 బంధువు 	(Bandhuvu)	
cover 	 కవర్ 	(Kavar)	
covered 	 కవర్ చేయబడింది 	(Kavar cēyabaḍindi)	
covering 	 కవరింగ్ 	(Kavariṅg)	
cover up 	 కప్పిపుచ్చుకుంటారు 	(Kappipuccukuṇṭāru)	
cow 	 ఆవు 	(Āvu)	
crack 	 పగుళ్లు 	(Paguḷlu)	
cracked 	 పగులగొట్టింది 	(Pagulagoṭṭindi)	
craft 	 క్రాఫ్ట్ 	(Krāphṭ)	
crash 	 క్రాష్ 	(Krāṣ)	
crazy 	 వెర్రి 	(Verri)	
cream 	 క్రీమ్ 	(Krīm)	
create 	 సృష్టించు 	(Sr̥ṣṭin̄cu)	
creature 	 జీవి 	(Jīvi)	
credit 	 క్రెడిట్ 	(Kreḍiṭ)	
credit card 	 క్రెడిట్ కార్డ్ 	(Kreḍiṭ kārḍ)	
crime 	 నేరం 	(Nēraṁ)	
criminal 	 నేరస్థుడు 	(Nērasthuḍu)	
crisis 	 సంక్షోభం 	(Saṅkṣōbhaṁ)	
crisp 	 స్ఫుటమైన 	(Sphuṭamaina)	
criterion 	 ప్రమాణం 	(Pramāṇaṁ)	
critical 	 క్లిష్టమైన 	(Kliṣṭamaina)	
criticism 	 విమర్శ 	(Vimarśa)	
criticize 	 విమర్శించండి 	(Vimarśin̄caṇḍi)	
crop 	 పంట 	(Paṇṭa)	
cross 	 క్రాస్ 	(Krās)	
cross out 	 క్రాస్ అవుట్ 	(Krās avuṭ)	
crowd 	 గుంపు 	(Gumpu)	
crowded 	 రద్దీగా ఉంది 	(Raddīgā undi)	
crown 	 కిరీటం 	(Kirīṭaṁ)	
crucial 	 కీలకమైన 	(Kīlakamaina)	
cruel 	 క్రూరమైన 	(Krūramaina)	
crush 	 క్రష్ 	(Kraṣ)	
cry 	 ఏడుస్తారు 	(Ēḍustāru)	
cry out 	 కేకలు వేయండి 	(Kēkalu vēyaṇḍi)	
cultural 	 సాంస్కృతిక 	(Sānskr̥tika)	
culture 	 సంస్కృతి 	(Sanskr̥ti)	
cup 	 కప్పు 	(Kappu)	
cupboard 	 అల్మారా 	(Almārā)	
curb 	 అరికట్టండి 	(Arikaṭṭaṇḍi)	
cure 	 నయం 	(Nayaṁ)	
curious 	 ఆసక్తిగా 	(Āsaktigā)	
curiously 	 ఆసక్తిగా 	(Āsaktigā)	
curl 	 కర్ల్ 	(Karl)	
curl up 	 వంకరగా 	(Vaṅkaragā)	
curly 	 గిరజాల 	(Girajāla)	
current 	 ప్రస్తుత 	(Prastuta)	
currently 	 ప్రస్తుతం 	(Prastutaṁ)	
curtain 	 తెర 	(Tera)	
curve 	 వంపు 	(Vampu)	
curved 	 వంపు తిరిగింది 	(Vampu tirigindi)	
custom 	 ఆచారం 	(Ācāraṁ)	
customer 	 కస్టమర్ 	(Kasṭamar)	
customs 	 ఆచారాలు 	(Ācārālu)	
cut 	 కట్ 	(Kaṭ)	
cut back 	 తగ్గించండి 	(Taggin̄caṇḍi)	
cut down 	 నరికి 	(Nariki)	
cut off 	 తెగిపోయింది 	(Tegipōyindi)	
cut out 	 కటౌట్ 	(Kaṭauṭ)	
cut up 	 కట్ అప్ 	(Kaṭ ap)	
cycle 	 చక్రం 	(Cakraṁ)	
cycling 	 సైకిల్ తొక్కడం 	(Saikil tokkaḍaṁ)	
dad 	 నాన్న 	(Nānna)	
daily 	 రోజువారీ 	(Rōjuvārī)	
damage 	 నష్టం 	(Naṣṭaṁ)	
damp 	 తడిగా 	(Taḍigā)	
dance 	 నృత్యం 	(Nr̥tyaṁ)	
dancer 	 నర్తకి 	(Nartaki)	
dancing 	 నృత్యం 	(Nr̥tyaṁ)	
danger 	 ప్రమాదం 	(Pramādaṁ)	
dangerous 	 ప్రమాదకరమైన 	(Pramādakaramaina)	
dare 	 ధైర్యం 	(Dhairyaṁ)	
dark 	 చీకటి 	(Cīkaṭi)	
data 	 డేటా 	(Ḍēṭā)	
date 	 తేదీ 	(Tēdī)	
date back 	 నాటిది 	(Nāṭidi)	
daughter 	 కూతురు 	(Kūturu)	
day 	 రోజు 	(Rōju)	
dead 	 చనిపోయాడు 	(Canipōyāḍu)	
deaf 	 చెవిటివాడు 	(Ceviṭivāḍu)	
deal 	 ఒప్పందం 	(Oppandaṁ)	
deal in 	 ఒప్పందం 	(Oppandaṁ)	
deal with 	 వ్యవహరించండి 	(Vyavaharin̄caṇḍi)	
dear 	 ప్రియమైన 	(Priyamaina)	
death 	 మరణం 	(Maraṇaṁ)	
debate 	 చర్చ 	(Carca)	
debt 	 అప్పు 	(Appu)	
decade 	 దశాబ్దం 	(Daśābdaṁ)	
decay 	 క్షయం 	(Kṣayaṁ)	
December 	 డిసెంబర్ 	(Ḍisembar)	
decide 	 నిర్ణయించుకుంటారు 	(Nirṇayin̄cukuṇṭāru)	
decide on 	 నిర్ణయించుకుంటారు 	(Nirṇayin̄cukuṇṭāru)	
decision 	 నిర్ణయం 	(Nirṇayaṁ)	
declare 	 ప్రకటించండి 	(Prakaṭin̄caṇḍi)	
decline 	 తగ్గుదల 	(Taggudala)	
decorate 	 అలంకరించండి 	(Alaṅkarin̄caṇḍi)	
decoration 	 అలంకరణ 	(Alaṅkaraṇa)	
decorative 	 అలంకారమైన 	(Alaṅkāramaina)	
decrease 	 తగ్గుదల 	(Taggudala)	
deep 	 లోతైన 	(Lōtaina)	
deeply 	 లోతుగా 	(Lōtugā)	
defeat 	 ఓటమి 	(Ōṭami)	
defence 	 రక్షణ 	(Rakṣaṇa)	
defend 	 రక్షించు 	(Rakṣin̄cu)	
define 	 నిర్వచించండి 	(Nirvacin̄caṇḍi)	
definite 	 ఖచ్చితమైన 	(Khaccitamaina)	
definitely 	 ఖచ్చితంగా 	(Khaccitaṅgā)	
definition 	 నిర్వచనం 	(Nirvacanaṁ)	
degree 	 డిగ్రీ 	(Ḍigrī)	
delay 	 ఆలస్యం 	(Ālasyaṁ)	
deliberate 	 ఉద్దేశపూర్వకంగా 	(Uddēśapūrvakaṅgā)	
deliberately 	 ఉద్దేశపూర్వకంగా 	(Uddēśapūrvakaṅgā)	
delicate 	 సున్నితమైన 	(Sunnitamaina)	
delight 	 ఆనందం 	(Ānandaṁ)	
delighted 	 సంతోషించారు 	(Santōṣin̄cāru)	
deliver 	 బట్వాడా 	(Baṭvāḍā)	
delivery 	 డెలివరీ 	(Ḍelivarī)	
demand 	 డిమాండ్ 	(Ḍimāṇḍ)	
demonstrate 	 ప్రదర్శించండి 	(Pradarśin̄caṇḍi)	
dentist 	 దంతవైద్యుడు 	(Dantavaidyuḍu)	
deny 	 తిరస్కరించు 	(Tiraskarin̄cu)	
department 	 శాఖ 	(Śākha)	
departure 	 నిష్క్రమణ 	(Niṣkramaṇa)	
depend 	 ఆధారపడి ఉంటాయి 	(Ādhārapaḍi uṇṭāyi)	
depend on 	 ఆధారపడి ఉంటాయి 	(Ādhārapaḍi uṇṭāyi)	
deposit 	 డిపాజిట్ 	(Ḍipājiṭ)	
depress 	 నిస్పృహ 	(Nispr̥ha)	
depressed 	 అణగారిన 	(Aṇagārina)	
depressing 	 నిరుత్సాహపరుస్తుంది 	(Nirutsāhaparustundi)	
depth 	 లోతు 	(Lōtu)	
derive 	 ఉత్పన్నం 	(Utpannaṁ)	
derive from 	 నుండి ఉద్భవించాయి 	(Nuṇḍi udbhavin̄cāyi)	
describe 	 వర్ణించండి 	(Varṇin̄caṇḍi)	
description 	 వివరణ 	(Vivaraṇa)	
desert 	 ఎడారి 	(Eḍāri)	
deserted 	 ఎడారి 	(Eḍāri)	
deserve 	 అర్హులు 	(Ar'hulu)	
design 	 డిజైన్ 	(Ḍijain)	
desire 	 కోరిక 	(Kōrika)	
desk 	 డెస్క్ 	(Ḍesk)	
desperate 	 తీరని 	(Tīrani)	
desperately 	 నిర్విరామంగా 	(Nirvirāmaṅgā)	
despite 	 ఉన్నప్పటికీ 	(Unnappaṭikī)	
destroy 	 నాశనం 	(Nāśanaṁ)	
destruction 	 విధ్వంసం 	(Vidhvansaṁ)	
detail 	 వివరాలు 	(Vivarālu)	
detailed 	 వివరంగా 	(Vivaraṅgā)	
determination 	 సంకల్పం 	(Saṅkalpaṁ)	
determine 	 నిర్ణయిస్తాయి 	(Nirṇayistāyi)	
determined 	 నిర్ణయించారు 	(Nirṇayin̄cāru)	
develop 	 అభివృద్ధి 	(Abhivr̥d'dhi)	
development 	 అభివృద్ధి 	(Abhivr̥d'dhi)	
device 	 పరికరం 	(Parikaraṁ)	
devote 	 అంకితం 	(Aṅkitaṁ)	
devoted 	 అంకితం చేయబడింది 	(Aṅkitaṁ cēyabaḍindi)	
devote to 	 అంకితం 	(Aṅkitaṁ)	
diagram 	 రేఖాచిత్రం 	(Rēkhācitraṁ)	
diamond 	 వజ్రం 	(Vajraṁ)	
diary 	 డైరీ 	(Ḍairī)	
dictionary 	 నిఘంటువు 	(Nighaṇṭuvu)	
die 	 చనిపోతారు 	(Canipōtāru)	
die away 	 చనిపోతారు 	(Canipōtāru)	
die out 	 చనిపోతాయి 	(Canipōtāyi)	
diet 	 ఆహారం 	(Āhāraṁ)	
difference 	 తేడా 	(Tēḍā)	
different 	 భిన్నమైనది 	(Bhinnamainadi)	
differently 	 భిన్నంగా 	(Bhinnaṅgā)	
difficult 	 కష్టం 	(Kaṣṭaṁ)	
difficulty 	 కష్టం 	(Kaṣṭaṁ)	
dig 	 తవ్వు 	(Tavvu)	
digital 	 డిజిటల్ 	(Ḍijiṭal)	
dinner 	 విందు 	(Vindu)	
direct 	 ప్రత్యక్షంగా 	(Pratyakṣaṅgā)	
direction 	 దిశ 	(Diśa)	
directly 	 నేరుగా 	(Nērugā)	
director 	 దర్శకుడు 	(Darśakuḍu)	
dirt 	 మురికి 	(Muriki)	
dirty 	 మురికి 	(Muriki)	
disabled 	 వికలాంగుడు 	(Vikalāṅguḍu)	
disadvantage 	 ప్రతికూలత 	(Pratikūlata)	
disagree 	 ఏకీభవించలేదు 	(Ēkībhavin̄calēdu)	
disagreement 	 అసమ్మతి 	(Asam'mati)	
disagree with doing 	 చేయడంతో విభేదిస్తున్నారు 	(Cēyaḍantō vibhēdistunnāru)	
disappear 	 అదృశ్యం 	(Adr̥śyaṁ)	
disappoint 	 నిరాశ 	(Nirāśa)	
disappointed 	 నిరాశ చెందాడు 	(Nirāśa cendāḍu)	
disappointing 	 నిరాశపరిచింది 	(Nirāśaparicindi)	
disappointment 	 నిరాశ 	(Nirāśa)	
disapproval 	 అసమ్మతి 	(Asam'mati)	
disapprove 	 ఒప్పుకోరు 	(Oppukōru)	
disapproving 	 నిరాకరించడం 	(Nirākarin̄caḍaṁ)	
disaster 	 విపత్తు 	(Vipattu)	
disc 	 డిస్క్ 	(Ḍisk)	
discipline 	 క్రమశిక్షణ 	(Kramaśikṣaṇa)	
discount 	 తగ్గింపు 	(Taggimpu)	
discover 	 కనుగొనండి 	(Kanugonaṇḍi)	
discovery 	 ఆవిష్కరణ 	(Āviṣkaraṇa)	
discuss 	 చర్చించండి 	(Carcin̄caṇḍi)	
discussion 	 చర్చ 	(Carca)	
disease 	 వ్యాధి 	(Vyādhi)	
disgust 	 అసహ్యం 	(Asahyaṁ)	
disgusted 	 అసహ్యం వేసింది 	(Asahyaṁ vēsindi)	
disgusting 	 అసహ్యకరమైన 	(Asahyakaramaina)	
dish 	 వంటకం 	(Vaṇṭakaṁ)	
dishonest 	 నిజాయితీ లేని 	(Nijāyitī lēni)	
dishonestly 	 నిజాయితీ లేకుండా 	(Nijāyitī lēkuṇḍā)	
disk 	 డిస్క్ 	(Ḍisk)	
dislike 	 అయిష్టం 	(Ayiṣṭaṁ)	
dismiss 	 తొలగించు 	(Tolagin̄cu)	
display 	 ప్రదర్శన 	(Pradarśana)	
dissolve 	 కరిగిపోతాయి 	(Karigipōtāyi)	
distance 	 దూరం 	(Dūraṁ)	
distinguish 	 వేరు 	(Vēru)	
distribute 	 పంపిణీ 	(Pampiṇī)	
distribution 	 పంపిణీ 	(Pampiṇī)	
district 	 జిల్లా 	(Jillā)	
disturb 	 భంగం కలిగించు 	(Bhaṅgaṁ kaligin̄cu)	
disturbing 	 కలవరపెడుతోంది 	(Kalavarapeḍutōndi)	
divide 	 విభజించు 	(Vibhajin̄cu)	
division 	 విభజన 	(Vibhajana)	
divorce 	 విడాకులు 	(Viḍākulu)	
divorced 	 విడాకులు తీసుకున్నారు 	(Viḍākulu tīsukunnāru)	
do 1 	 చేయండి 1 	(Cēyaṇḍi 1)	
doctor 	 వైద్యుడు 	(Vaidyuḍu)	
document 	 పత్రం 	(Patraṁ)	
dog 	 కుక్క 	(Kukka)	
dollar 	 డాలర్ 	(Ḍālar)	
domestic 	 దేశీయ 	(Dēśīya)	
dominate 	 ఆధిపత్యం చెలాయిస్తాయి 	(Ādhipatyaṁ celāyistāyi)	
door 	 తలుపు 	(Talupu)	
dot 	 చుక్క 	(Cukka)	
double 	 రెట్టింపు 	(Reṭṭimpu)	
doubt 	 సందేహం 	(Sandēhaṁ)	
do up 	 అప్ చేయండి 	(Ap cēyaṇḍi)	
do with 	 తో చేయండి 	(Tō cēyaṇḍi)	
do without 	 లేకుండా చేయండి 	(Lēkuṇḍā cēyaṇḍi)	
down 	 క్రిందికి 	(Krindiki)	
downstairs 	 మెట్లమీద 	(Meṭlamīda)	
downward 	 క్రిందికి 	(Krindiki)	
downwards 	 క్రిందికి 	(Krindiki)	
dozen 	 డజను 	(Ḍajanu)	
draft 	 డ్రాఫ్ట్ 	(Ḍrāphṭ)	
drag 	 లాగండి 	(Lāgaṇḍi)	
drama 	 నాటకం 	(Nāṭakaṁ)	
dramatic 	 నాటకీయమైన 	(Nāṭakīyamaina)	
dramatically 	 నాటకీయంగా 	(Nāṭakīyaṅgā)	
draw 	 డ్రా 	(Ḍrā)	
drawer 	 సొరుగు 	(Sorugu)	
drawing 	 డ్రాయింగ్ 	(Ḍrāyiṅg)	
dream 	 కల 	(Kala)	
dress 	 దుస్తులు 	(Dustulu)	
dressed 	 దుస్తులు ధరించారు 	(Dustulu dharin̄cāru)	
dress up 	 దుస్తులు ధరించండి 	(Dustulu dharin̄caṇḍi)	
drink 	 త్రాగండి 	(Trāgaṇḍi)	
drive 	 డ్రైవ్ 	(Ḍraiv)	
drive away 	 తరిమికొట్టండి 	(Tarimikoṭṭaṇḍi)	
drive off 	 తరిమికొట్టండి 	(Tarimikoṭṭaṇḍi)	
driver 	 డ్రైవర్ 	(Ḍraivar)	
driving 	 డ్రైవింగ్ 	(Ḍraiviṅg)	
drop 	 డ్రాప్ 	(Ḍrāp)	
drop out 	 డ్రాప్ అవుట్ 	(Ḍrāp avuṭ)	
drug 	 మందు 	(Mandu)	
drugstore 	 మందుల దుకాణం 	(Mandula dukāṇaṁ)	
drum 	 డ్రమ్ 	(Ḍram)	
drunk 	 తాగిన 	(Tāgina)	
dry 	 పొడి 	(Poḍi)	
dry off 	 పొడిగా 	(Poḍigā)	
dry up 	 ఎండిపోతాయి 	(Eṇḍipōtāyi)	
due 	 రావాల్సి ఉంది 	(Rāvālsi undi)	
dull 	 నిస్తేజంగా 	(Nistējaṅgā)	
dump 	 డంప్ 	(Ḍamp)	
during 	 సమయంలో 	(Samayanlō)	
dust 	 దుమ్ము 	(Dum'mu)	
duty 	 విధి 	(Vidhi)	
DVD 	 DVD 	(DVD)	
dying 	 చనిపోతున్నది 	(Canipōtunnadi)	
each 	 ప్రతి 	(Prati)	
each other 	 ఒకరికొకరు 	(Okarikokaru)	
ear 	 చెవి 	(Cevi)	
early 	 ప్రారంభ 	(Prārambha)	
earn 	 సంపాదిస్తారు 	(Sampādistāru)	
earth 	 భూమి 	(Bhūmi)	
ease 	 తేలిక 	(Tēlika)	
easily 	 సులభంగా 	(Sulabhaṅgā)	
east 	 తూర్పు 	(Tūrpu)	
eastern 	 తూర్పు 	(Tūrpu)	
easy 	 సులభంగా 	(Sulabhaṅgā)	
eat 	 తినండి 	(Tinaṇḍi)	
eat out 	 బయట తినండి 	(Bayaṭa tinaṇḍi)	
eat up 	 తిను 	(Tinu)	
economic 	 ఆర్థిక 	(Ārthika)	
economy 	 ఆర్థిక వ్యవస్థ 	(Ārthika vyavastha)	
edge 	 అంచు 	(An̄cu)	
edition 	 ఎడిషన్ 	(Eḍiṣan)	
editor 	 సంపాదకుడు 	(Sampādakuḍu)	
educate 	 చదువు 	(Caduvu)	
educated 	 విద్యావంతుడు 	(Vidyāvantuḍu)	
education 	 విద్య 	(Vidya)	
effect 	 ప్రభావం 	(Prabhāvaṁ)	
effective 	 సమర్థవంతమైన 	(Samarthavantamaina)	
effectively 	 సమర్థవంతంగా 	(Samarthavantaṅgā)	
efficient 	 సమర్థవంతమైన 	(Samarthavantamaina)	
efficiently 	 సమర్ధవంతంగా 	(Samardhavantaṅgā)	
effort 	 కృషి 	(Kr̥ṣi)	
e.g. 	 ఉదా 	(Udā)	
egg 	 గుడ్డు 	(Guḍḍu)	
eight 	 ఎనిమిది 	(Enimidi)	
eighteen 	 పద్దెనిమిది 	(Paddenimidi)	
eighteenth 	 పద్దెనిమిదవది 	(Paddenimidavadi)	
eighth 	 ఎనిమిదవది 	(Enimidavadi)	
eightieth 	 ఎనభైవది 	(Enabhaivadi)	
eighty 	 ఎనభై 	(Enabhai)	
either 	 గాని 	(Gāni)	
elbow 	 మోచేయి 	(Mōcēyi)	
elderly 	 వృద్ధుడు 	(Vr̥d'dhuḍu)	
elect 	 ఎన్నుకోబడతారు 	(Ennukōbaḍatāru)	
election 	 ఎన్నిక 	(Ennika)	
electric 	 విద్యుత్ 	(Vidyut)	
electrical 	 విద్యుత్ 	(Vidyut)	
electricity 	 విద్యుత్ 	(Vidyut)	
electronic 	 ఎలక్ట్రానిక్ 	(Elakṭrānik)	
elegant 	 సొగసైన 	(Sogasaina)	
element 	 మూలకం 	(Mūlakaṁ)	
elevator 	 ఎలివేటర్ 	(Elivēṭar)	
eleven 	 పదకొండు 	(Padakoṇḍu)	
eleventh 	 పదకొండవ 	(Padakoṇḍava)	
else 	 వేరే 	(Vērē)	
elsewhere 	 మరెక్కడా 	(Marekkaḍā)	
email 	 ఇమెయిల్ 	(Imeyil)	
embarrass 	 ఇబ్బంది 	(Ibbandi)	
embarrassed 	 ఇబ్బందిపడ్డాడు 	(Ibbandipaḍḍāḍu)	
embarrassing 	 ఇబ్బందికరంగా 	(Ibbandikaraṅgā)	
embarrassment 	 ఇబ్బంది 	(Ibbandi)	
emerge 	 ఉద్భవిస్తాయి 	(Udbhavistāyi)	
emergency 	 అత్యవసర 	(Atyavasara)	
emotion 	 భావోద్వేగం 	(Bhāvōdvēgaṁ)	
emotional 	 భావోద్వేగ 	(Bhāvōdvēga)	
emotionally 	 మానసికంగా 	(Mānasikaṅgā)	
emphasis 	 ఉద్ఘాటన 	(Udghāṭana)	
emphasize 	 నొక్కిచెప్పండి 	(Nokkiceppaṇḍi)	
empire 	 సామ్రాజ్యం 	(Sāmrājyaṁ)	
employ 	 ఉపాధి కల్పిస్తాయి 	(Upādhi kalpistāyi)	
employee 	 ఉద్యోగి 	(Udyōgi)	
employer 	 యజమాని 	(Yajamāni)	
employment 	 ఉపాధి 	(Upādhi)	
empty 	 ఖాళీ 	(Khāḷī)	
enable 	 ప్రారంభించు 	(Prārambhin̄cu)	
encounter 	 ఎన్కౌంటర్ 	(Enkauṇṭar)	
encourage 	 ప్రోత్సహిస్తాయి 	(Prōtsahistāyi)	
encouragement 	 ప్రోత్సాహం 	(Prōtsāhaṁ)	
end 	 ముగింపు 	(Mugimpu)	
end in 	 ముగుస్తుంది 	(Mugustundi)	
ending 	 ముగింపు 	(Mugimpu)	
end up 	 ముగుస్తుంది 	(Mugustundi)	
enemy 	 శత్రువు 	(Śatruvu)	
energy 	 శక్తి 	(Śakti)	
engage 	 నిమగ్నమై 	(Nimagnamai)	
engaged 	 నిశ్చితార్థం 	(Niścitārthaṁ)	
engine 	 ఇంజిన్ 	(In̄jin)	
engineer 	 ఇంజనీర్ 	(In̄janīr)	
engineering 	 ఇంజనీరింగ్ 	(In̄janīriṅg)	
enjoy 	 ఆనందించండి 	(Ānandin̄caṇḍi)	
enjoyable 	 ఆనందించే 	(Ānandin̄cē)	
enjoyment 	 ఆనందం 	(Ānandaṁ)	
enormous 	 అపారమైన 	(Apāramaina)	
enough 	 తగినంత 	(Taginanta)	
enquiry 	 విచారణ 	(Vicāraṇa)	
ensure 	 నిర్ధారించండి 	(Nirdhārin̄caṇḍi)	
enter 	 ఎంటర్ 	(Eṇṭar)	
entertain 	 వినోదం 	(Vinōdaṁ)	
entertainer 	 వినోదిని 	(Vinōdini)	
entertaining 	 వినోదాత్మకంగా 	(Vinōdātmakaṅgā)	
entertainment 	 వినోదం 	(Vinōdaṁ)	
enthusiasm 	 ఉత్సాహం 	(Utsāhaṁ)	
enthusiastic 	 ఉత్సాహభరితమైన 	(Utsāhabharitamaina)	
enthusiastically 	 ఉత్సాహంగా 	(Utsāhaṅgā)	
entire 	 మొత్తం 	(Mottaṁ)	
entirely 	 పూర్తిగా 	(Pūrtigā)	
entitle 	 హక్కు 	(Hakku)	
entrance 1 	 ప్రవేశ 1 	(Pravēśa 1)	
entry 	 ప్రవేశం 	(Pravēśaṁ)	
envelope 	 కవరు 	(Kavaru)	
environment 	 పర్యావరణం 	(Paryāvaraṇaṁ)	
environmental 	 పర్యావరణ 	(Paryāvaraṇa)	
equal 	 సమానం 	(Samānaṁ)	
equally 	 సమానంగా 	(Samānaṅgā)	
equipment 	 పరికరాలు 	(Parikarālu)	
equivalent 	 సమానమైన 	(Samānamaina)	
error 	 లోపం 	(Lōpaṁ)	
escape 	 తప్పించుకుంటారు 	(Tappin̄cukuṇṭāru)	
especially 	 ముఖ్యంగా 	(Mukhyaṅgā)	
essay 	 వ్యాసం 	(Vyāsaṁ)	
essential 	 అవసరమైన 	(Avasaramaina)	
essentially 	 ముఖ్యంగా 	(Mukhyaṅgā)	
establish 	 ఏర్పాటు 	(Ērpāṭu)	
estate 	 ఎస్టేట్ 	(Esṭēṭ)	
estimate 	 అంచనా 	(An̄canā)	
etc. 	 మొదలైనవి 	(Modalainavi)	
euro 	 యూరో 	(Yūrō)	
even 	 కూడా 	(Kūḍā)	
evening 	 సాయంత్రం 	(Sāyantraṁ)	
event 	 సంఘటన 	(Saṅghaṭana)	
eventually 	 చివరికి 	(Civariki)	
ever 	 ఎప్పుడూ 	(Eppuḍū)	
every 	 ప్రతి 	(Prati)	
everybody 	 అందరూ 	(Andarū)	
everyone 	 ప్రతి ఒక్కరూ 	(Prati okkarū)	
everything 	 ప్రతిదీ 	(Pratidī)	
everywhere 	 ప్రతిచోటా 	(Praticōṭā)	
evidence 	 సాక్ష్యం 	(Sākṣyaṁ)	
evil 	 చెడు 	(Ceḍu)	
ex- 	 మాజీ- 	(Mājī-)	
exact 	 ఖచ్చితమైన 	(Khaccitamaina)	
exactly 	 సరిగ్గా 	(Sariggā)	
exaggerate 	 అతిశయోక్తి 	(Atiśayōkti)	
exaggerated 	 అతిశయోక్తి 	(Atiśayōkti)	
exam 	 పరీక్ష 	(Parīkṣa)	
examination 	 పరీక్ష 	(Parīkṣa)	
examine 	 పరిశీలించండి 	(Pariśīlin̄caṇḍi)	
example 	 ఉదాహరణ 	(Udāharaṇa)	
excellent 	 అద్భుతమైన 	(Adbhutamaina)	
except 	 తప్ప 	(Tappa)	
exception 	 మినహాయింపు 	(Minahāyimpu)	
exchange 	 మార్పిడి 	(Mārpiḍi)	
excite 	 ఉత్తేజపరుస్తాయి 	(Uttējaparustāyi)	
excited 	 ఉత్సాహంగా 	(Utsāhaṅgā)	
excitement 	 ఉత్సాహం 	(Utsāhaṁ)	
exciting 	 ఉత్తేజకరమైన 	(Uttējakaramaina)	
exclude 	 మినహాయించండి 	(Minahāyin̄caṇḍi)	
excluding 	 మినహాయించి 	(Minahāyin̄ci)	
excuse 	 మన్నించు 	(Mannin̄cu)	
executive 	 కార్యనిర్వాహకుడు 	(Kāryanirvāhakuḍu)	
exercise 	 వ్యాయామం 	(Vyāyāmaṁ)	
exhibit 	 ప్రదర్శించు 	(Pradarśin̄cu)	
exhibition 	 ప్రదర్శన 	(Pradarśana)	
exist 	 ఉనికిలో ఉన్నాయి 	(Unikilō unnāyi)	
existence 	 ఉనికి 	(Uniki)	
exit 	 నిష్క్రమించు 	(Niṣkramin̄cu)	
expand 	 విస్తరించండి 	(Vistarin̄caṇḍi)	
expect 	 ఆశించవచ్చు 	(Āśin̄cavaccu)	
expectation 	 నిరీక్షణ 	(Nirīkṣaṇa)	
expected 	 ఊహించబడింది 	(Ūhin̄cabaḍindi)	
expense 	 ఖర్చు 	(Kharcu)	
expensive 	 ఖరీదైన 	(Kharīdaina)	
experience 	 అనుభవం 	(Anubhavaṁ)	
experienced 	 అనుభవించాడు 	(Anubhavin̄cāḍu)	
experiment 	 ప్రయోగం 	(Prayōgaṁ)	
expert 	 నిపుణుడు 	(Nipuṇuḍu)	
explain 	 వివరించండి 	(Vivarin̄caṇḍi)	
explanation 	 వివరణ 	(Vivaraṇa)	
explode 	 పేలుడు 	(Pēluḍu)	
explore 	 అన్వేషించండి 	(Anvēṣin̄caṇḍi)	
explosion 	 పేలుడు 	(Pēluḍu)	
export 	 ఎగుమతి 	(Egumati)	
expose 	 బహిర్గతం చేయండి 	(Bahirgataṁ cēyaṇḍi)	
express 	 ఎక్స్ప్రెస్ 	(Ekspres)	
expression 	 వ్యక్తీకరణ 	(Vyaktīkaraṇa)	
extend 	 విస్తరించు 	(Vistarin̄cu)	
extension 	 పొడిగింపు 	(Poḍigimpu)	
extensive 	 విస్తృతమైన 	(Vistr̥tamaina)	
extent 	 మేరకు 	(Mēraku)	
extra 	 అదనపు 	(Adanapu)	
extraordinary 	 అసాధారణమైన 	(Asādhāraṇamaina)	
extreme 	 తీవ్రమైన 	(Tīvramaina)	
extremely 	 అత్యంత 	(Atyanta)	
eye 	 కన్ను 	(Kannu)	
face 	 ముఖం 	(Mukhaṁ)	
face up to 	 వరకు ముఖం 	(Varaku mukhaṁ)	
facility 	 సౌకర్యం 	(Saukaryaṁ)	
fact 	 వాస్తవం 	(Vāstavaṁ)	
factor 	 కారకం 	(Kārakaṁ)	
factory 	 కర్మాగారం 	(Karmāgāraṁ)	
fail 	 విఫలం 	(Viphalaṁ)	
failure 	 వైఫల్యం 	(Vaiphalyaṁ)	
faint 	 మూర్ఛపోతుంది 	(Mūrchapōtundi)	
faintly 	 మందకొడిగా 	(Mandakoḍigā)	
fair 	 న్యాయమైన 	(N'yāyamaina)	
fairly 	 న్యాయంగా 	(N'yāyaṅgā)	
faith 	 విశ్వాసం 	(Viśvāsaṁ)	
faithful 	 నమ్మకమైన 	(Nam'makamaina)	
faithfully 	 నమ్మకంగా 	(Nam'makaṅgā)	
fall 	 పతనం 	(Patanaṁ)	
false 	 తప్పుడు 	(Tappuḍu)	
fame 	 కీర్తి 	(Kīrti)	
familiar 	 తెలిసిన 	(Telisina)	
family 	 కుటుంబం 	(Kuṭumbaṁ)	
famous 	 ప్రసిద్ధి 	(Prasid'dhi)	
fan 	 అభిమాని 	(Abhimāni)	
fancy 	 ఫాన్సీ 	(Phānsī)	
far 	 చాలా దూరం 	(Cālā dūraṁ)	
farm 	 పొలం 	(Polaṁ)	
farmer 	 రైతు 	(Raitu)	
farming 	 వ్యవసాయం 	(Vyavasāyaṁ)	
farther 	 దూరంగా 	(Dūraṅgā)	
farthest 	 చాలా దూరం 	(Cālā dūraṁ)	
fashion 	 ఫ్యాషన్ 	(Phyāṣan)	
fashionable 	 ఫ్యాషన్ 	(Phyāṣan)	
fast 	 వేగంగా 	(Vēgaṅgā)	
fasten 	 కట్టు 	(Kaṭṭu)	
fat 	 లావు 	(Lāvu)	
father 	 తండ్రి 	(Taṇḍri)	
faucet 	 పీపాలో నుంచి నీళ్లు బయిటికి రావడమునకు వేసివుండే చిన్న గొట్టము 	(Pīpālō nun̄ci nīḷlu bayiṭiki rāvaḍamunaku vēsivuṇḍē cinna goṭṭamu)	
fault 	 తప్పు 	(Tappu)	
favour 	 అనుకూలంగా 	(Anukūlaṅgā)	
favourite 	 ఇష్టమైన 	(Iṣṭamaina)	
fear 	 భయం 	(Bhayaṁ)	
feather 	 ఈక 	(Īka)	
feature 	 లక్షణం 	(Lakṣaṇaṁ)	
February 	 ఫిబ్రవరి 	(Phibravari)	
federal 	 సమాఖ్య 	(Samākhya)	
fee 	 రుసుము 	(Rusumu)	
feed 	 తిండి 	(Tiṇḍi)	
feel 	 అనుభూతి 	(Anubhūti)	
feeling 	 అనుభూతి 	(Anubhūti)	
fellow 	 తోటి 	(Tōṭi)	
female 	 స్త్రీ 	(Strī)	
fence 	 కంచె 	(Kan̄ce)	
festival 	 పండుగ 	(Paṇḍuga)	
fetch 	 తీసుకుని 	(Tīsukuni)	
fever 	 జ్వరం 	(Jvaraṁ)	
few 	 కొన్ని 	(Konni)	
field 	 ఫీల్డ్ 	(Phīlḍ)	
fifteen 	 పదిహేను 	(Padihēnu)	
fifteenth 	 పదిహేనవది 	(Padihēnavadi)	
fifth 	 ఐదవది 	(Aidavadi)	
fiftieth 	 యాభైవది 	(Yābhaivadi)	
fifty 	 యాభై 	(Yābhai)	
fight 	 పోరాడు 	(Pōrāḍu)	
fighting 	 పోరాడుతున్నారు 	(Pōrāḍutunnāru)	
figure 	 బొమ్మ 	(Bom'ma)	
figure out 	 గుర్తించండి 	(Gurtin̄caṇḍi)	
file 	 ఫైల్ 	(Phail)	
fill 	 నింపండి 	(Nimpaṇḍi)	
fill in 	 పూరించండి 	(Pūrin̄caṇḍi)	
fill out 	 పూరించండి 	(Pūrin̄caṇḍi)	
fill up 	 నింపండి 	(Nimpaṇḍi)	
film 	 చిత్రం 	(Citraṁ)	
final 	 ఫైనల్ 	(Phainal)	
finally 	 చివరకు 	(Civaraku)	
finance 	 ఫైనాన్స్ 	(Phaināns)	
financial 	 ఆర్థిక 	(Ārthika)	
find 	 కనుగొనండి 	(Kanugonaṇḍi)	
find out 	 కనుక్కోండి 	(Kanukkōṇḍi)	
fine 	 జరిమానా 	(Jarimānā)	
finely 	 చక్కగా 	(Cakkagā)	
finger 	 వేలు 	(Vēlu)	
finish 	 పూర్తి 	(Pūrti)	
finished 	 పూర్తయింది 	(Pūrtayindi)	
finish off 	 ముగించు 	(Mugin̄cu)	
fire 	 అగ్ని 	(Agni)	
firm 	 సంస్థ 	(Sanstha)	
firmly 	 దృఢంగా 	(Dr̥ḍhaṅgā)	
first 	 మొదటి 	(Modaṭi)	
fish 	 చేప 	(Cēpa)	
fishing 	 చేపలు పట్టడం 	(Cēpalu paṭṭaḍaṁ)	
fit 	 సరిపోయింది 	(Saripōyindi)	
fit in 	 సరిపోతాయి 	(Saripōtāyi)	
five 	 ఐదు 	(Aidu)	
fix 	 పరిష్కరించండి 	(Pariṣkarin̄caṇḍi)	
fixed 	 పరిష్కరించబడింది 	(Pariṣkarin̄cabaḍindi)	
flag 	 జెండా 	(Jeṇḍā)	
flame 	 జ్వాల 	(Jvāla)	
flash 	 ఫ్లాష్ 	(Phlāṣ)	
flat 	 ఫ్లాట్ 	(Phlāṭ)	
flavour 	 రుచి 	(Ruci)	
flesh 	 మాంసం 	(Mānsaṁ)	
flight 	 విమానము 	(Vimānamu)	
float 	 తేలుతుంది 	(Tēlutundi)	
flood 	 వరద 	(Varada)	
flooded 	 వరదలు వచ్చాయి 	(Varadalu vaccāyi)	
flooding 	 వరదలు 	(Varadalu)	
floor 	 అంతస్తు 	(Antastu)	
flour 	 పిండి 	(Piṇḍi)	
flow 	 ప్రవాహం 	(Pravāhaṁ)	
flower 	 పువ్వు 	(Puvvu)	
flu 	 ఫ్లూ 	(Phlū)	
fly 	 ఎగురుతాయి 	(Egurutāyi)	
flying 	 ఎగురుతూ 	(Egurutū)	
focus 	 దృష్టి 	(Dr̥ṣṭi)	
fold 	 రెట్లు 	(Reṭlu)	
folding 	 మడత 	(Maḍata)	
follow 	 అనుసరించండి 	(Anusarin̄caṇḍi)	
following 	 అనుసరించడం 	(Anusarin̄caḍaṁ)	
follow up 	 అనుసరించండి 	(Anusarin̄caṇḍi)	
food 	 ఆహారం 	(Āhāraṁ)	
foot 	 అడుగు 	(Aḍugu)	
football 	 ఫుట్బాల్ 	(Phuṭbāl)	
for 	 కోసం 	(Kōsaṁ)	
force 	 బలవంతం 	(Balavantaṁ)	
forecast 	 సూచన 	(Sūcana)	
foreign 	 విదేశీ 	(Vidēśī)	
forest 	 అడవి 	(Aḍavi)	
forever 	 ఎప్పటికీ 	(Eppaṭikī)	
forget 	 మర్చిపోతారు 	(Marcipōtāru)	
forgive 	 క్షమించు 	(Kṣamin̄cu)	
fork 	 ఫోర్క్ 	(Phōrk)	
form 	 రూపం 	(Rūpaṁ)	
formal 	 అధికారిక 	(Adhikārika)	
formally 	 అధికారికంగా 	(Adhikārikaṅgā)	
former 	 మాజీ 	(Mājī)	
formerly 	 పూర్వం 	(Pūrvaṁ)	
formula 	 సూత్రం 	(Sūtraṁ)	
fortieth 	 నలభైవది 	(Nalabhaivadi)	
fortune 	 అదృష్టం 	(Adr̥ṣṭaṁ)	
forty 	 నలభై 	(Nalabhai)	
forward 	 ముందుకు 	(Munduku)	
found 	 దొరికింది 	(Dorikindi)	
foundation 	 పునాది 	(Punādi)	
four 	 నాలుగు 	(Nālugu)	
fourteen 	 పద్నాలుగు 	(Padnālugu)	
fourteenth 	 పద్నాలుగో 	(Padnālugō)	
fourth 	 నాల్గవది 	(Nālgavadi)	
frame 	 ఫ్రేమ్ 	(Phrēm)	
free 	 ఉచిత 	(Ucita)	
freedom 	 స్వేచ్ఛ 	(Svēccha)	
freely 	 స్వేచ్ఛగా 	(Svēcchagā)	
freeze 	 ఫ్రీజ్ 	(Phrīj)	
frequent 	 తరచుగా 	(Taracugā)	
frequently 	 తరచుగా 	(Taracugā)	
fresh 	 తాజా 	(Tājā)	
freshly 	 తాజాగా 	(Tājāgā)	
Friday 	 శుక్రవారం 	(Śukravāraṁ)	
fridge 	 ఫ్రిజ్ 	(Phrij)	
friend 	 స్నేహితుడు 	(Snēhituḍu)	
friendly 	 స్నేహపూర్వక 	(Snēhapūrvaka)	
friendship 	 స్నేహం 	(Snēhaṁ)	
frighten 	 భయపెట్టు 	(Bhayapeṭṭu)	
frighten away/off 	 భయపెట్టండి/ఆఫ్ చేయండి 	(Bhayapeṭṭaṇḍi/āph cēyaṇḍi)	
frightened 	 భయపడ్డాను 	(Bhayapaḍḍānu)	
frightening 	 భయపెట్టే 	(Bhayapeṭṭē)	
from 	 నుండి 	(Nuṇḍi)	
front 	 ముందు 	(Mundu)	
frozen 	 ఘనీభవించిన 	(Ghanībhavin̄cina)	
fruit 	 పండు 	(Paṇḍu)	
fry 	 వేయించు 	(Vēyin̄cu)	
fuel 	 ఇంధనం 	(Indhanaṁ)	
full 	 పూర్తి 	(Pūrti)	
fully 	 పూర్తిగా 	(Pūrtigā)	
fun 	 సరదాగా 	(Saradāgā)	
function 	 ఫంక్షన్ 	(Phaṅkṣan)	
function as 	 ఫంక్షన్ 	(Phaṅkṣan)	
fund 	 నిధి 	(Nidhi)	
fundamental 	 ప్రాథమిక 	(Prāthamika)	
funeral 	 అంత్యక్రియలు 	(Antyakriyalu)	
funny 	 తమాషా 	(Tamāṣā)	
fur 	 బొచ్చు 	(Boccu)	
furniture 	 ఫర్నిచర్ 	(Pharnicar)	
further 	 మరింత 	(Marinta)	
future 	 భవిష్యత్తు 	(Bhaviṣyattu)	
gain 	 లాభం 	(Lābhaṁ)	
gallon 	 గాలన్ 	(Gālan)	
gamble 	 జూదం 	(Jūdaṁ)	
gambling 	 జూదం 	(Jūdaṁ)	
game 	 ఆట 	(Āṭa)	
gap 	 అంతరం 	(Antaraṁ)	
garage 	 గారేజ్ 	(Gārēj)	
garbage 	 చెత్త 	(Cetta)	
garden 	 తోట 	(Tōṭa)	
gas 	 వాయువు 	(Vāyuvu)	
gasoline 	 గ్యాసోలిన్ 	(Gyāsōlin)	
gate 	 ద్వారం 	(Dvāraṁ)	
gather 	 సేకరించండి 	(Sēkarin̄caṇḍi)	
gear 	 గేర్ 	(Gēr)	
general 	 సాధారణ 	(Sādhāraṇa)	
generally 	 సాధారణంగా 	(Sādhāraṇaṅgā)	
generate 	 ఉత్పత్తి 	(Utpatti)	
generation 	 తరం 	(Taraṁ)	
generous 	 ఉదారంగా 	(Udāraṅgā)	
generously 	 ఉదారంగా 	(Udāraṅgā)	
gentle 	 సౌమ్యుడు 	(Saumyuḍu)	
gentleman 	 పెద్దమనిషి 	(Peddamaniṣi)	
gently 	 శాంతముగా 	(Śāntamugā)	
genuine 	 నిజమైన 	(Nijamaina)	
genuinely 	 యదార్ధంగా 	(Yadārdhaṅgā)	
geography 	 భూగోళశాస్త్రం 	(Bhūgōḷaśāstraṁ)	
get 	 పొందండి 	(Pondaṇḍi)	
get away 	 దూరంగా పొందండి 	(Dūraṅgā pondaṇḍi)	
get away with 	 దూరంగా పొందండి 	(Dūraṅgā pondaṇḍi)	
get back 	 తిరిగి పొందండి 	(Tirigi pondaṇḍi)	
get by 	 ద్వారా పొందండి 	(Dvārā pondaṇḍi)	
get in 	 ప్రవేశించు 	(Pravēśin̄cu)	
get into 	 ప్రవేశించండి 	(Pravēśin̄caṇḍi)	
get off 	 దిగిపో 	(Digipō)	
get on 	 పొందండి 	(Pondaṇḍi)	
get on with 	 తో పొందండి 	(Tō pondaṇḍi)	
get out of 	 బయటపడండి 	(Bayaṭapaḍaṇḍi)	
get over 	 పైగా పొందండి 	(Paigā pondaṇḍi)	
get round 	 చుట్టుముట్టండి 	(Cuṭṭumuṭṭaṇḍi)	
get round to 	 చుట్టూ చేరండి 	(Cuṭṭū cēraṇḍi)	
get through 	 ద్వారా పొందండి 	(Dvārā pondaṇḍi)	
get up 	 లేవండి 	(Lēvaṇḍi)	
giant 	 దిగ్గజం 	(Diggajaṁ)	
gift 	 బహుమతి 	(Bahumati)	
girl 	 అమ్మాయి 	(Am'māyi)	
girlfriend 	 ప్రియురాలు 	(Priyurālu)	
give 	 ఇస్తాయి 	(Istāyi)	
give away 	 ఇస్తాయి 	(Istāyi)	
give back 	 తిరిగి ఇస్తాయి 	(Tirigi istāyi)	
give in 	 ఇవ్వండి 	(Ivvaṇḍi)	
give off 	 ఆఫ్ ఇస్తాయి 	(Āph istāyi)	
give out 	 ఇవ్వండి 	(Ivvaṇḍi)	
give up 	 వదులుకో 	(Vadulukō)	
glad 	 సంతోషం 	(Santōṣaṁ)	
glass 	 గాజు 	(Gāju)	
global 	 ప్రపంచ 	(Prapan̄ca)	
glove 	 చేతి తొడుగు 	(Cēti toḍugu)	
glue 	 జిగురు 	(Jiguru)	
go 	 వెళ్ళు 	(Veḷḷu)	
go ahead 	 ముందుకు సాగండి 	(Munduku sāgaṇḍi)	
goal 	 లక్ష్యం 	(Lakṣyaṁ)	
go away 	 వెళ్ళిపో 	(Veḷḷipō)	
go back 	 తిరిగి వెళ్ళు 	(Tirigi veḷḷu)	
go back to 	 తిరిగి వెళ్ళు 	(Tirigi veḷḷu)	
go by 	 వెళ్ళు 	(Veḷḷu)	
god 	 దేవుడు 	(Dēvuḍu)	
go down 	 క్రిందికి వెళ్ళు 	(Krindiki veḷḷu)	
go into 	 లోకి వెళ్ళండి 	(Lōki veḷḷaṇḍi)	
gold 	 బంగారం 	(Baṅgāraṁ)	
good 	 మంచి 	(Man̄ci)	
goodbye 	 వీడ్కోలు 	(Vīḍkōlu)	
goods 	 వస్తువులు 	(Vastuvulu)	
go off 	 వెళ్ళిపో 	(Veḷḷipō)	
go on 	 కొనసాగండి 	(Konasāgaṇḍi)	
go on doing 	 చేస్తూనే ఉండండి 	(Cēstūnē uṇḍaṇḍi)	
go out 	 బయటకు వెళ్ళు 	(Bayaṭaku veḷḷu)	
go out with 	 తో బయటకు వెళ్ళు 	(Tō bayaṭaku veḷḷu)	
go over 	 పైగా వెళ్ళండి 	(Paigā veḷḷaṇḍi)	
go round 	 చుట్టూ తిరగండి 	(Cuṭṭū tiragaṇḍi)	
go through 	 గుండా వెళ్ళండి 	(Guṇḍā veḷḷaṇḍi)	
go through with 	 తో ద్వారా వెళ్ళండి 	(Tō dvārā veḷḷaṇḍi)	
go to 	 వెళ్ళండి 	(Veḷḷaṇḍi)	
go up 	 పైకి వెళ్ళు 	(Paiki veḷḷu)	
govern 	 పాలించు 	(Pālin̄cu)	
government 	 ప్రభుత్వం 	(Prabhutvaṁ)	
governor 	 గవర్నర్ 	(Gavarnar)	
go with 	 తో వెళ్ళండి 	(Tō veḷḷaṇḍi)	
go without 	 లేకుండా వెళ్ళండి 	(Lēkuṇḍā veḷḷaṇḍi)	
grab 	 పట్టుకో 	(Paṭṭukō)	
grade 	 గ్రేడ్ 	(Grēḍ)	
gradual 	 క్రమంగా 	(Kramaṅgā)	
gradually 	 క్రమంగా 	(Kramaṅgā)	
grain 	 ధాన్యం 	(Dhān'yaṁ)	
gram 	 గ్రాము 	(Grāmu)	
grammar 	 వ్యాకరణం 	(Vyākaraṇaṁ)	
grand 	 గొప్ప 	(Goppa)	
grandchild 	 మనవడు 	(Manavaḍu)	
granddaughter 	 మనవరాలు 	(Manavarālu)	
grandfather 	 తాతయ్య 	(Tātayya)	
grandmother 	 అమ్మమ్మ 	(Am'mam'ma)	
grandparent 	 తాతయ్య 	(Tātayya)	
grandson 	 మనవడు 	(Manavaḍu)	
grant 	 మంజూరు 	(Man̄jūru)	
grass 	 గడ్డి 	(Gaḍḍi)	
grateful 	 కృతజ్ఞతతో 	(Kr̥tajñatatō)	
grave 1 	 సమాధి 1 	(Samādhi 1)	
gravely 	 గంభీరంగా 	(Gambhīraṅgā)	
great 	 గొప్ప 	(Goppa)	
greatly 	 గొప్పగా 	(Goppagā)	
green 	 ఆకుపచ్చ 	(Ākupacca)	
grey 	 బూడిద రంగు 	(Būḍida raṅgu)	
grocery 	 కిరాణా 	(Kirāṇā)	
ground 	 నేల 	(Nēla)	
group 	 సమూహం 	(Samūhaṁ)	
grow 	 పెరుగుతాయి 	(Perugutāyi)	
growth 	 వృద్ధి 	(Vr̥d'dhi)	
grow up 	 పెరుగుతాయి 	(Perugutāyi)	
guarantee 	 హామీ 	(Hāmī)	
guard 	 కాపలా 	(Kāpalā)	
guess 	 అంచనా 	(An̄canā)	
guest 	 అతిథి 	(Atithi)	
guide 	 మార్గదర్శకుడు 	(Mārgadarśakuḍu)	
guilty 	 దోషి 	(Dōṣi)	
gun 	 తుపాకీ 	(Tupākī)	
guy 	 వ్యక్తి 	(Vyakti)	
habit 	 అలవాటు 	(Alavāṭu)	
hair 	 జుట్టు 	(Juṭṭu)	
hairdresser 	 క్షౌరశాల 	(Kṣauraśāla)	
half 	 సగం 	(Sagaṁ)	
hall 	 హాలు 	(Hālu)	
hammer 	 సుత్తి 	(Sutti)	
hand 	 చేతి 	(Cēti)	
hand back 	 తిరిగి చేయి 	(Tirigi cēyi)	
hand down 	 చేయి డౌన్ 	(Cēyi ḍaun)	
hand in 	 చేయి 	(Cēyi)	
handle 	 హ్యాండిల్ 	(Hyāṇḍil)	
hand out 	 చేయి 	(Cēyi)	
hand over 	 అప్పగించండి 	(Appagin̄caṇḍi)	
hand round 	 చేతి రౌండ్ 	(Cēti rauṇḍ)	
hang 	 వేలాడదీయండి 	(Vēlāḍadīyaṇḍi)	
hang about 	 గురించి వ్రేలాడదీయు 	(Gurin̄ci vrēlāḍadīyu)	
hang about with 	 తో కాలక్షేపం 	(Tō kālakṣēpaṁ)	
hang around 	 చుట్టూ తొంగి చూస్తారు 	(Cuṭṭū toṅgi cūstāru)	
hang around with 	 చుట్టూ తిరుగుతారు 	(Cuṭṭū tirugutāru)	
hang on 	 వేలాడదీయండి 	(Vēlāḍadīyaṇḍi)	
hang on to 	 వేలాడదీయండి 	(Vēlāḍadīyaṇḍi)	
hang up 	 వేలాడదీయండి 	(Vēlāḍadīyaṇḍi)	
happen 	 జరుగుతాయి 	(Jarugutāyi)	
happen to 	 జరుగుతుంది 	(Jarugutundi)	
happily 	 సంతోషంగా 	(Santōṣaṅgā)	
happiness 	 ఆనందం 	(Ānandaṁ)	
happy 	 సంతోషంగా ఉంది 	(Santōṣaṅgā undi)	
hard 	 కష్టం 	(Kaṣṭaṁ)	
hardly 	 అరుదుగా 	(Arudugā)	
harm 	 హాని 	(Hāni)	
harmful 	 హానికరమైన 	(Hānikaramaina)	
harmless 	 ప్రమాదకరం 	(Pramādakaraṁ)	
hat 	 టోపీ 	(Ṭōpī)	
hate 	 ద్వేషించు 	(Dvēṣin̄cu)	
hatred 	 ద్వేషం 	(Dvēṣaṁ)	
have 	 కలిగి ఉంటాయి 	(Kaligi uṇṭāyi)	
have back 	 తిరిగి పొందండి 	(Tirigi pondaṇḍi)	
have on 	 కలిగి ఉంటాయి 	(Kaligi uṇṭāyi)	
have to 	 వుంటుంది 	(Vuṇṭundi)	
he 	 అతను 	(Atanu)	
head 	 తల 	(Tala)	
headache 	 తలనొప్పి 	(Talanoppi)	
heal 	 నయం 	(Nayaṁ)	
health 	 ఆరోగ్యం 	(Ārōgyaṁ)	
healthy 	 ఆరోగ్యకరమైన 	(Ārōgyakaramaina)	
hear 	 వినండి 	(Vinaṇḍi)	
hear from 	 నుండి వినండి 	(Nuṇḍi vinaṇḍi)	
hearing 	 వినికిడి 	(Vinikiḍi)	
hear of 	 విను 	(Vinu)	
heart 	 గుండె 	(Guṇḍe)	
heat 	 వేడి 	(Vēḍi)	
heating 	 వేడి చేయడం 	(Vēḍi cēyaḍaṁ)	
heat up 	 వేడెక్కుతుంది 	(Vēḍekkutundi)	
heaven 	 స్వర్గం 	(Svargaṁ)	
heavily 	 భారీగా 	(Bhārīgā)	
heavy 	 భారీ 	(Bhārī)	
heel 	 మడమ 	(Maḍama)	
height 	 ఎత్తు 	(Ettu)	
hell 	 నరకం 	(Narakaṁ)	
hello 	 హలో 	(Halō)	
help 	 సహాయం 	(Sahāyaṁ)	
helpful 	 సహాయకారిగా 	(Sahāyakārigā)	
help out 	 సహాయం చేయండి 	(Sahāyaṁ cēyaṇḍi)	
hence 	 అందుకే 	(Andukē)	
her 	 ఆమె 	(Āme)	
here 	 ఇక్కడ 	(Ikkaḍa)	
hero 	 హీరో 	(Hīrō)	
hers 	 ఆమెది 	(Āmedi)	
herself 	 ఆమె 	(Āme)	
hesitate 	 సంకోచించండి 	(Saṅkōcin̄caṇḍi)	
hi 	 హాయ్ 	(Hāy)	
hide 	 దాచు 	(Dācu)	
high 	 అధిక 	(Adhika)	
highlight 	 హైలైట్ 	(Hailaiṭ)	
highly 	 అత్యంత 	(Atyanta)	
highway 	 హైవే 	(Haivē)	
hill 	 కొండ 	(Koṇḍa)	
him 	 అతనిని 	(Atanini)	
himself 	 తాను 	(Tānu)	
hip 	 తుంటి 	(Tuṇṭi)	
hire 	 కిరాయి 	(Kirāyi)	
hire out 	 అద్దెకు తీసుకుంటారు 	(Addeku tīsukuṇṭāru)	
his 	 అతని 	(Atani)	
historical 	 చారిత్రక 	(Cāritraka)	
history 	 చరిత్ర 	(Caritra)	
hit 	 కొట్టాడు 	(Koṭṭāḍu)	
hobby 	 అభిరుచి 	(Abhiruci)	
hold 	 పట్టుకోండి 	(Paṭṭukōṇḍi)	
hold back 	 తిరిగి పట్టుకోండి 	(Tirigi paṭṭukōṇḍi)	
hold on 	 పట్టుకోండి 	(Paṭṭukōṇḍi)	
hold on to 	 పట్టుకోండి 	(Paṭṭukōṇḍi)	
hold out 	 పట్టుకోండి 	(Paṭṭukōṇḍi)	
hold up 	 పట్టుకోండి 	(Paṭṭukōṇḍi)	
hole 	 రంధ్రం 	(Randhraṁ)	
holiday 	 సెలవు 	(Selavu)	
hollow 	 బోలుగా 	(Bōlugā)	
holy 	 పవిత్రమైనది 	(Pavitramainadi)	
home 	 ఇల్లు 	(Illu)	
homework 	 హోంవర్క్ 	(Hōnvark)	
honest 	 నిజాయితీ 	(Nijāyitī)	
honestly 	 నిజాయితీగా 	(Nijāyitīgā)	
honour 	 గౌరవం 	(Gauravaṁ)	
hook 	 హుక్ 	(Huk)	
hope 	 ఆశ 	(Āśa)	
horizontal 	 అడ్డంగా 	(Aḍḍaṅgā)	
horn 	 కొమ్ము 	(Kom'mu)	
horror 	 భయానక 	(Bhayānaka)	
horse 	 గుర్రం 	(Gurraṁ)	
hospital 	 ఆసుపత్రి 	(Āsupatri)	
host 	 హోస్ట్ 	(Hōsṭ)	
hot 	 వేడి 	(Vēḍi)	
hotel 	 హోటల్ 	(Hōṭal)	
hour 	 గంట 	(Gaṇṭa)	
house 	 ఇల్లు 	(Illu)	
household 	 గృహ 	(Gr̥ha)	
housing 	 గృహనిర్మాణం 	(Gr̥hanirmāṇaṁ)	
how 	 ఎలా 	(Elā)	
however 	 అయితే 	(Ayitē)	
huge 	 భారీ 	(Bhārī)	
human 	 మానవుడు 	(Mānavuḍu)	
humorous 	 హాస్యభరితమైన 	(Hāsyabharitamaina)	
humour 	 హాస్యం 	(Hāsyaṁ)	
hundred 	 వంద 	(Vanda)	
hundredth 	 వందో 	(Vandō)	
hungry 	 ఆకలిగా ఉంది 	(Ākaligā undi)	
hunt 	 వేట 	(Vēṭa)	
hunting 	 వేట 	(Vēṭa)	
hurry 	 త్వరపడండి 	(Tvarapaḍaṇḍi)	
hurry up 	 త్వరపడండి 	(Tvarapaḍaṇḍi)	
hurt 	 బాధించింది 	(Bādhin̄cindi)	
husband 	 భర్త 	(Bharta)	
I 	 I 	(I)	
ice 	 మంచు 	(Man̄cu)	
ice cream 	 ఐస్ క్రీం 	(Ais krīṁ)	
idea 	 ఆలోచన 	(Ālōcana)	
ideal 	 ఆదర్శవంతమైనది 	(Ādarśavantamainadi)	
identify 	 గుర్తించండి 	(Gurtin̄caṇḍi)	
identify with 	 తో గుర్తించండి 	(Tō gurtin̄caṇḍi)	
identity 	 గుర్తింపు 	(Gurtimpu)	
i.e. 	 అనగా 	(Anagā)	
if 	 ఉంటే 	(Uṇṭē)	
ignore 	 పట్టించుకోకండి 	(Paṭṭin̄cukōkaṇḍi)	
ill 	 అనారోగ్యంతో 	(Anārōgyantō)	
illegal 	 చట్టవిరుద్ధం 	(Caṭṭavirud'dhaṁ)	
illegally 	 చట్టవిరుద్ధంగా 	(Caṭṭavirud'dhaṅgā)	
illness 	 రోగము 	(Rōgamu)	
illustrate 	 వర్ణించండి 	(Varṇin̄caṇḍi)	
image 	 చిత్రం 	(Citraṁ)	
imaginary 	 ఊహాత్మకమైన 	(Ūhātmakamaina)	
imagination 	 ఊహ 	(Ūha)	
imagine 	 ఊహించుకోండి 	(Ūhin̄cukōṇḍi)	
immediate 	 వెంటనే 	(Veṇṭanē)	
immediately 	 వెంటనే 	(Veṇṭanē)	
immoral 	 అనైతిక 	(Anaitika)	
impact 	 ప్రభావం 	(Prabhāvaṁ)	
impatient 	 అసహనం 	(Asahanaṁ)	
implication 	 తాత్పర్యం 	(Tātparyaṁ)	
imply 	 సూచిస్తుంది 	(Sūcistundi)	
import 	 దిగుమతి 	(Digumati)	
importance 	 ప్రాముఖ్యత 	(Prāmukhyata)	
important 	 ముఖ్యమైన 	(Mukhyamaina)	
importantly 	 ముఖ్యంగా 	(Mukhyaṅgā)	
impose 	 విధిస్తాయి 	(Vidhistāyi)	
impossible 	 అసాధ్యం 	(Asādhyaṁ)	
impress 	 ఆకట్టుకుంటారు 	(Ākaṭṭukuṇṭāru)	
impressed 	 ఆకట్టుకున్నాడు 	(Ākaṭṭukunnāḍu)	
impression 	 ముద్ర 	(Mudra)	
impressive 	 ఆకట్టుకునే 	(Ākaṭṭukunē)	
improve 	 మెరుగుపరుస్తాయి 	(Meruguparustāyi)	
improvement 	 అభివృద్ధి 	(Abhivr̥d'dhi)	
in 	 లో 	(Lō)	
inability 	 అసమర్థత 	(Asamarthata)	
inch 	 అంగుళం 	(Aṅguḷaṁ)	
incident 	 సంఘటన 	(Saṅghaṭana)	
include 	 చేర్చండి 	(Cērcaṇḍi)	
including 	 సహా 	(Sahā)	
income 	 ఆదాయం 	(Ādāyaṁ)	
increase 	 పెరుగుతుంది 	(Perugutundi)	
increasingly 	 పెరుగుతున్న 	(Perugutunna)	
indeed 	 నిజానికి 	(Nijāniki)	
independence 	 స్వాతంత్ర్యం 	(Svātantryaṁ)	
independent 	 స్వతంత్ర 	(Svatantra)	
independently 	 స్వతంత్రంగా 	(Svatantraṅgā)	
index 	 సూచిక 	(Sūcika)	
indicate 	 సూచిస్తాయి 	(Sūcistāyi)	
indication 	 సూచన 	(Sūcana)	
indirect 	 పరోక్షంగా 	(Parōkṣaṅgā)	
indirectly 	 పరోక్షంగా 	(Parōkṣaṅgā)	
individual 	 వ్యక్తిగత 	(Vyaktigata)	
indoor 	 ఇండోర్ 	(Iṇḍōr)	
indoors 	 ఇంటి లోపల 	(Iṇṭi lōpala)	
industrial 	 పారిశ్రామిక 	(Pāriśrāmika)	
industry 	 పరిశ్రమ 	(Pariśrama)	
inevitable 	 అనివార్యమైన 	(Anivāryamaina)	
inevitably 	 అనివార్యంగా 	(Anivāryaṅgā)	
infect 	 సంక్రమిస్తాయి 	(Saṅkramistāyi)	
infected 	 సోకినది 	(Sōkinadi)	
infection 	 సంక్రమణ 	(Saṅkramaṇa)	
infectious 	 అంటువ్యాధి 	(Aṇṭuvyādhi)	
influence 	 ప్రభావం 	(Prabhāvaṁ)	
inform 	 తెలియజేయండి 	(Teliyajēyaṇḍi)	
informal 	 అనధికారిక 	(Anadhikārika)	
information 	 సమాచారం 	(Samācāraṁ)	
ingredient 	 పదార్ధం 	(Padārdhaṁ)	
initial 	 ప్రారంభ 	(Prārambha)	
initially 	 ప్రారంభంలో 	(Prārambhanlō)	
initiative 	 చొరవ 	(Corava)	
injure 	 గాయపరచు 	(Gāyaparacu)	
injured 	 గాయపడ్డారు 	(Gāyapaḍḍāru)	
injury 	 గాయం 	(Gāyaṁ)	
ink 	 సిరా 	(Sirā)	
inner 	 లోపలి 	(Lōpali)	
innocent 	 నిర్దోషి 	(Nirdōṣi)	
insect 	 కీటకం 	(Kīṭakaṁ)	
insert 	 చొప్పించు 	(Coppin̄cu)	
inside 	 లోపల 	(Lōpala)	
insist 	 పట్టుబట్టుతారు 	(Paṭṭubaṭṭutāru)	
insist on 	 పట్టుబట్టారు 	(Paṭṭubaṭṭāru)	
insist on doing 	 చేయాలని పట్టుబట్టారు 	(Cēyālani paṭṭubaṭṭāru)	
install 	 ఇన్స్టాల్ 	(Insṭāl)	
instance 	 ఉదాహరణ 	(Udāharaṇa)	
instead 	 బదులుగా 	(Badulugā)	
instead of 	 బదులుగా 	(Badulugā)	
institute 	 ఇన్స్టిట్యూట్ 	(Insṭiṭyūṭ)	
institution 	 సంస్థ 	(Sanstha)	
instruction 	 సూచన 	(Sūcana)	
instrument 	 వాయిద్యం 	(Vāyidyaṁ)	
insult 	 అవమానించడం 	(Avamānin̄caḍaṁ)	
insulting 	 అవమానకరం 	(Avamānakaraṁ)	
insurance 	 భీమా 	(Bhīmā)	
intelligence 	 తెలివితేటలు 	(Telivitēṭalu)	
intelligent 	 తెలివైన 	(Telivaina)	
intend 	 ఉద్దేశ్యము 	(Uddēśyamu)	
intended 	 ఉద్దేశించబడింది 	(Uddēśin̄cabaḍindi)	
intention 	 ఉద్దేశం 	(Uddēśaṁ)	
interest 	 ఆసక్తి 	(Āsakti)	
interested 	 ఆసక్తి 	(Āsakti)	
interesting 	 ఆసక్తికరమైన 	(Āsaktikaramaina)	
interior 	 అంతర్గత 	(Antargata)	
internal 	 అంతర్గత 	(Antargata)	
international 	 అంతర్జాతీయ 	(Antarjātīya)	
Internet 	 ఇంటర్నెట్ 	(Iṇṭarneṭ)	
interpret 	 అన్వయించు 	(Anvayin̄cu)	
interpretation 	 వివరణ 	(Vivaraṇa)	
interrupt 	 అంతరాయం కలిగించు 	(Antarāyaṁ kaligin̄cu)	
interruption 	 అంతరాయం 	(Antarāyaṁ)	
interval 	 విరామం 	(Virāmaṁ)	
interview 	 ఇంటర్వ్యూ 	(Iṇṭarvyū)	
into 	 లోకి 	(Lōki)	
introduce 	 పరిచయం 	(Paricayaṁ)	
introduction 	 పరిచయం 	(Paricayaṁ)	
invent 	 కనిపెట్టు 	(Kanipeṭṭu)	
invention 	 ఆవిష్కరణ 	(Āviṣkaraṇa)	
invest 	 పెట్టుబడి పెట్టండి 	(Peṭṭubaḍi peṭṭaṇḍi)	
investigate 	 దర్యాప్తు చేయండి 	(Daryāptu cēyaṇḍi)	
investigation 	 విచారణ 	(Vicāraṇa)	
investment 	 పెట్టుబడి 	(Peṭṭubaḍi)	
invitation 	 ఆహ్వానం 	(Āhvānaṁ)	
invite 	 ఆహ్వానించండి 	(Āhvānin̄caṇḍi)	
involve 	 ప్రమేయం 	(Pramēyaṁ)	
involved 	 చేరి 	(Cēri)	
involvement 	 ప్రమేయం 	(Pramēyaṁ)	
iron 	 ఇనుము 	(Inumu)	
irritate 	 చిరాకు 	(Cirāku)	
irritated 	 చిరాకుపడ్డాడు 	(Cirākupaḍḍāḍu)	
irritating 	 చిరాకు 	(Cirāku)	
island 	 ద్వీపం 	(Dvīpaṁ)	
issue 	 సమస్య 	(Samasya)	
it 	 అది 	(Adi)	
item 	 అంశం 	(Anśaṁ)	
its 	 దాని 	(Dāni)	
itself 	 స్వయంగా 	(Svayaṅgā)	
jacket 	 జాకెట్ 	(Jākeṭ)	
jam 	 జామ్ 	(Jām)	
January 	 జనవరి 	(Janavari)	
jealous 	 అసూయ 	(Asūya)	
jeans 	 జీన్స్ 	(Jīns)	
jelly 	 జెల్లీ 	(Jellī)	
jewellery 	 నగలు 	(Nagalu)	
job 	 ఉద్యోగం 	(Udyōgaṁ)	
join 	 చేరండి 	(Cēraṇḍi)	
join in 	 చేరండి 	(Cēraṇḍi)	
joint 	 ఉమ్మడి 	(Um'maḍi)	
jointly 	 సంయుక్తంగా 	(Sanyuktaṅgā)	
joke 	 తమాషా 	(Tamāṣā)	
journalist 	 పాత్రికేయుడు 	(Pātrikēyuḍu)	
journey 	 ప్రయాణం 	(Prayāṇaṁ)	
joy 	 ఆనందం 	(Ānandaṁ)	
judge 	 న్యాయమూర్తి 	(N'yāyamūrti)	
judgement 	 తీర్పు 	(Tīrpu)	
juice 	 రసం 	(Rasaṁ)	
July 	 జూలై 	(Jūlai)	
jump 	 దూకుతారు 	(Dūkutāru)	
June 	 జూన్ 	(Jūn)	
junior 	 జూనియర్ 	(Jūniyar)	
just 	 కేవలం 	(Kēvalaṁ)	
justice 	 న్యాయం 	(N'yāyaṁ)	
justified 	 సమర్థించుకున్నారు 	(Samarthin̄cukunnāru)	
justify 	 సమర్థించు 	(Samarthin̄cu)	
keen 	 ఆసక్తిగల 	(Āsaktigala)	
keep 	 ఉంచు 	(Un̄cu)	
keep out 	 దూరంగా ఉంచండి 	(Dūraṅgā un̄caṇḍi)	
keep out of 	 దూరంగా ఉంచండి 	(Dūraṅgā un̄caṇḍi)	
keep up 	 కొనసాగించు 	(Konasāgin̄cu)	
keep up with 	 కొనసాగించు 	(Konasāgin̄cu)	
key 	 కీ 	(Kī)	
keyboard 	 కీబోర్డ్ 	(Kībōrḍ)	
kick 	 తన్నండి 	(Tannaṇḍi)	
kid 	 చిన్నపిల్ల 	(Cinnapilla)	
kill 	 చంపేస్తాయి 	(Campēstāyi)	
killing 	 చంపడం 	(Campaḍaṁ)	
kilogram 	 కిలోగ్రాము 	(Kilōgrāmu)	
kilometre 	 కిలోమీటరు 	(Kilōmīṭaru)	
kind 	 రకమైన 	(Rakamaina)	
kindly 	 దయతో 	(Dayatō)	
kindness 	 దయ 	(Daya)	
king 	 రాజు 	(Rāju)	
kiss 	 ముద్దు 	(Muddu)	
kitchen 	 వంటగది 	(Vaṇṭagadi)	
knee 	 మోకాలు 	(Mōkālu)	
knife 	 కత్తి 	(Katti)	
knit 	 knit 	(Knit)	
knitted 	 అల్లిన 	(Allina)	
knitting 	 అల్లడం 	(Allaḍaṁ)	
knock 	 కొట్టు 	(Koṭṭu)	
knock down 	 పడగొట్టు 	(Paḍagoṭṭu)	
knock out 	 నాకౌట్ 	(Nākauṭ)	
knot 	 ముడి 	(Muḍi)	
know 	 తెలుసు 	(Telusu)	
knowledge 	 జ్ఞానం 	(Jñānaṁ)	
lab 	 ప్రయోగశాల 	(Prayōgaśāla)	
label 	 లేబుల్ 	(Lēbul)	
laboratory 	 ప్రయోగశాల 	(Prayōgaśāla)	
labour 	 శ్రమ 	(Śrama)	
lack 	 లేకపోవడం 	(Lēkapōvaḍaṁ)	
lacking 	 లేకపోవడం 	(Lēkapōvaḍaṁ)	
lady 	 స్త్రీ 	(Strī)	
lake 	 సరస్సు 	(Saras'su)	
lamp 	 దీపం 	(Dīpaṁ)	
land 	 భూమి 	(Bhūmi)	
landscape 	 ప్రకృతి దృశ్యం 	(Prakr̥ti dr̥śyaṁ)	
lane 	 లేన్ 	(Lēn)	
language 	 భాష 	(Bhāṣa)	
large 	 పెద్ద 	(Pedda)	
largely 	 ఎక్కువగా 	(Ekkuvagā)	
last 1 	 చివరి 1 	(Civari 1)	
late 	 ఆలస్యంగా 	(Ālasyaṅgā)	
later 	 తరువాత 	(Taruvāta)	
latest 	 తాజా 	(Tājā)	
latter 	 తరువాతి 	(Taruvāti)	
laugh 	 నవ్వు 	(Navvu)	
laugh at 	 నవ్వు 	(Navvu)	
launch 	 ప్రయోగ 	(Prayōga)	
law 	 చట్టం 	(Caṭṭaṁ)	
lawyer 	 న్యాయవాది 	(N'yāyavādi)	
lay 	 లే 	(Lē)	
layer 	 పొర 	(Pora)	
lazy 	 సోమరితనం 	(Sōmaritanaṁ)	
lead 1 	 దారి 1 	(Dāri 1)	
leader 	 నాయకుడు 	(Nāyakuḍu)	
leading 1 	 ప్రముఖ 1 	(Pramukha 1)	
leaf 	 ఆకు 	(Āku)	
league 	 లీగ్ 	(Līg)	
lean 	 సన్నగా 	(Sannagā)	
learn 	 నేర్చుకుంటారు 	(Nērcukuṇṭāru)	
least 	 కనీసం 	(Kanīsaṁ)	
leather 	 తోలు 	(Tōlu)	
leave 	 వదిలివేయండి 	(Vadilivēyaṇḍi)	
leave out 	 వదిలివేయండి 	(Vadilivēyaṇḍi)	
lecture 	 ఉపన్యాసం 	(Upan'yāsaṁ)	
left 	 వదిలేశారు 	(Vadilēśāru)	
leg 	 కాలు 	(Kālu)	
legal 	 చట్టపరమైన 	(Caṭṭaparamaina)	
legally 	 చట్టబద్ధంగా 	(Caṭṭabad'dhaṅgā)	
lemon 	 నిమ్మకాయ 	(Nim'makāya)	
lend 	 అప్పు ఇస్తాయి 	(Appu istāyi)	
length 	 పొడవు 	(Poḍavu)	
less 	 తక్కువ 	(Takkuva)	
lesson 	 పాఠం 	(Pāṭhaṁ)	
let 	 వీలు 	(Vīlu)	
let down 	 వదులుకో 	(Vadulukō)	
let off 	 వదలండి 	(Vadalaṇḍi)	
letter 	 లేఖ 	(Lēkha)	
level 	 స్థాయి 	(Sthāyi)	
library 	 లైబ్రరీ 	(Laibrarī)	
licence 	 లైసెన్స్ 	(Laisens)	
license 	 లైసెన్స్ 	(Laisens)	
lid 	 మూత 	(Mūta)	
lie 1 	 అబద్ధం 1 	(Abad'dhaṁ 1)	
lie 2 	 అబద్ధం 2 	(Abad'dhaṁ 2)	
lie around 	 చుట్టూ పడుకో 	(Cuṭṭū paḍukō)	
lie down 	 పడుకో 	(Paḍukō)	
life 	 జీవితం 	(Jīvitaṁ)	
lift 	 ఎత్తండి 	(Ettaṇḍi)	
light 	 కాంతి 	(Kānti)	
lightly 	 తేలికగా 	(Tēlikagā)	
like 	 ఇష్టం 	(Iṣṭaṁ)	
likely 	 అవకాశం 	(Avakāśaṁ)	
limit 	 పరిమితి 	(Parimiti)	
limited 	 పరిమితం 	(Parimitaṁ)	
limit to 	 పరిమితి 	(Parimiti)	
line 	 లైన్ 	(Lain)	
link 	 లింక్ 	(Liṅk)	
lip 	 పెదవి 	(Pedavi)	
liquid 	 ద్రవ 	(Drava)	
list 	 జాబితా 	(Jābitā)	
listen 	 వినండి 	(Vinaṇḍi)	
literature 	 సాహిత్యం 	(Sāhityaṁ)	
litre 	 లీటరు 	(Līṭaru)	
little 	 కొద్దిగా 	(Koddigā)	
live 1 	 ప్రత్యక్షం 1 	(Pratyakṣaṁ 1)	
live 2 	 ప్రత్యక్ష 2 	(Pratyakṣa 2)	
lively 	 ఉల్లాసంగా 	(Ullāsaṅgā)	
live on 	 జీవించు 	(Jīvin̄cu)	
live through 	 ద్వారా జీవించండి 	(Dvārā jīvin̄caṇḍi)	
live together 	 కలిసి జీవిస్తారు 	(Kalisi jīvistāru)	
living 	 జీవిస్తున్నాను 	(Jīvistunnānu)	
load 	 లోడ్ 	(Lōḍ)	
loan 	 రుణం 	(Ruṇaṁ)	
local 	 స్థానిక 	(Sthānika)	
locally 	 స్థానికంగా 	(Sthānikaṅgā)	
locate 	 గుర్తించండి 	(Gurtin̄caṇḍi)	
located 	 ఉన్న 	(Unna)	
location 	 స్థానం 	(Sthānaṁ)	
lock 	 తాళం వేయండి 	(Tāḷaṁ vēyaṇḍi)	
lock up 	 లాక్ అప్ 	(Lāk ap)	
logic 	 తర్కం 	(Tarkaṁ)	
logical 	 తార్కిక 	(Tārkika)	
lonely 	 ఒంటరి 	(Oṇṭari)	
long 	 పొడవు 	(Poḍavu)	
look 	 చూడు 	(Cūḍu)	
look after 	 చూసుకో 	(Cūsukō)	
look at 	 చూడండి 	(Cūḍaṇḍi)	
look down on 	 చిన్నచూపు చూడు 	(Cinnacūpu cūḍu)	
look forward to 	 ఎదురు చూస్తారు 	(Eduru cūstāru)	
look into 	 పరిశీలిస్తారు 	(Pariśīlistāru)	
look on 	 చూడు 	(Cūḍu)	
look on with 	 తో చూడండి 	(Tō cūḍaṇḍi)	
look out 	 చూడు 	(Cūḍu)	
look out for 	 కోసం చూడండి 	(Kōsaṁ cūḍaṇḍi)	
look round 	 చుట్టూ చూడండి 	(Cuṭṭū cūḍaṇḍi)	
look through 	 ద్వారా చూడండి 	(Dvārā cūḍaṇḍi)	
look up 	 పైకి చూడు 	(Paiki cūḍu)	
look up to 	 వరకు చూడండి 	(Varaku cūḍaṇḍi)	
loose 	 వదులుగా 	(Vadulugā)	
loosely 	 వదులుగా 	(Vadulugā)	
lord 	 ప్రభువు 	(Prabhuvu)	
lorry 	 లారీ 	(Lārī)	
lose 	 కోల్పోతారు 	(Kōlpōtāru)	
loss 	 నష్టం 	(Naṣṭaṁ)	
lost 	 ఓడిపోయింది 	(Ōḍipōyindi)	
lot 	 చాలా 	(Cālā)	
loud 	 బిగ్గరగా 	(Biggaragā)	
loudly 	 బిగ్గరగా 	(Biggaragā)	
love 	 ప్రేమ 	(Prēma)	
lovely 	 సుందరమైన 	(Sundaramaina)	
lover 	 ప్రేమికుడు 	(Prēmikuḍu)	
low 	 తక్కువ 	(Takkuva)	
loyal 	 విశ్వాసపాత్రుడు 	(Viśvāsapātruḍu)	
luck 	 అదృష్టం 	(Adr̥ṣṭaṁ)	
lucky 	 అదృష్టవంతుడు 	(Adr̥ṣṭavantuḍu)	
luggage 	 సామాను 	(Sāmānu)	
lump 	 ముద్ద 	(Mudda)	
lunch 	 మధ్యాహ్న భోజనం 	(Madhyāhna bhōjanaṁ)	
lung 	 ఊపిరితిత్తుల 	(Ūpiritittula)	
machine 	 యంత్రం 	(Yantraṁ)	
machinery 	 యంత్రాలు 	(Yantrālu)	
mad 	 పిచ్చి 	(Picci)	
magazine 	 పత్రిక 	(Patrika)	
magic 	 మంత్రము 	(Mantramu)	
mail 	 మెయిల్ 	(Meyil)	
main 	 ప్రధాన 	(Pradhāna)	
mainly 	 ప్రధానంగా 	(Pradhānaṅgā)	
maintain 	 నిర్వహించండి 	(Nirvahin̄caṇḍi)	
major 	 ప్రధానమైనది 	(Pradhānamainadi)	
majority 	 మెజారిటీ 	(Mejāriṭī)	
make 	 తయారు 	(Tayāru)	
make into 	 లోకి తయారు 	(Lōki tayāru)	
make up 	 తయారు 	(Tayāru)	
make-up 	 మేకప్ 	(Mēkap)	
make up for 	 కోసం తయారు 	(Kōsaṁ tayāru)	
male 	 పురుషుడు 	(Puruṣuḍu)	
mall 	 మాల్ 	(Māl)	
man 	 మనిషి 	(Maniṣi)	
manage 	 నిర్వహించండి 	(Nirvahin̄caṇḍi)	
management 	 నిర్వహణ 	(Nirvahaṇa)	
manager 	 మేనేజర్ 	(Mēnējar)	
manner 	 పద్ధతి 	(Pad'dhati)	
manufacture 	 తయారీ 	(Tayārī)	
manufacturer 	 తయారీదారు 	(Tayārīdāru)	
manufacturing 	 తయారీ 	(Tayārī)	
many 	 అనేక 	(Anēka)	
map 	 పటం 	(Paṭaṁ)	
march 	 మార్చ్ 	(Mārc)	
March 	 మార్చి 	(Mārci)	
mark 	 గుర్తు 	(Gurtu)	
market 	 మార్కెట్ 	(Mārkeṭ)	
marketing 	 మార్కెటింగ్ 	(Mārkeṭiṅg)	
marriage 	 వివాహం 	(Vivāhaṁ)	
married 	 పెళ్లయింది 	(Peḷlayindi)	
marry 	 పెళ్లి చేసుకుంటారు 	(Peḷli cēsukuṇṭāru)	
mass 	 ద్రవ్యరాశి 	(Dravyarāśi)	
massive 	 భారీ 	(Bhārī)	
master 	 మాస్టర్ 	(Māsṭar)	
match 	 మ్యాచ్ 	(Myāc)	
matching 	 సరిపోలే 	(Saripōlē)	
match up 	 సరిపోల్చండి 	(Saripōlcaṇḍi)	
mate 	 సహచరుడు 	(Sahacaruḍu)	
material 	 పదార్థం 	(Padārthaṁ)	
mathematics 	 గణితం 	(Gaṇitaṁ)	
matter 	 విషయం 	(Viṣayaṁ)	
maximum 	 గరిష్టంగా 	(Gariṣṭaṅgā)	
may 	 మే 	(Mē)	
May 	 మే 	(Mē)	
maybe 	 బహుశా 	(Bahuśā)	
mayor 	 మేయర్ 	(Mēyar)	
me 	 నన్ను 	(Nannu)	
meal 	 భోజనం 	(Bhōjanaṁ)	
mean 	 అర్థం 	(Arthaṁ)	
meaning 	 అర్థం 	(Arthaṁ)	
means 	 అర్థం 	(Arthaṁ)	
meanwhile 	 ఇంతలో 	(Intalō)	
measure 	 కొలత 	(Kolata)	
measurement 	 కొలత 	(Kolata)	
meat 	 మాంసం 	(Mānsaṁ)	
media 	 మీడియా 	(Mīḍiyā)	
medical 	 వైద్య 	(Vaidya)	
medicine 	 మందు 	(Mandu)	
medium 	 మధ్యస్థ 	(Madhyastha)	
meet 	 కలుసుకుంటారు 	(Kalusukuṇṭāru)	
meeting 	 సమావేశం 	(Samāvēśaṁ)	
meet up 	 కలుసుకుంటారు 	(Kalusukuṇṭāru)	
meet with 	 కలవాలి 	(Kalavāli)	
melt 	 కరుగుతాయి 	(Karugutāyi)	
member 	 సభ్యుడు 	(Sabhyuḍu)	
membership 	 సభ్యత్వం 	(Sabhyatvaṁ)	
memory 	 జ్ఞాపకశక్తి 	(Jñāpakaśakti)	
mental 	 మానసిక 	(Mānasika)	
mentally 	 మానసికంగా 	(Mānasikaṅgā)	
mention 	 ప్రస్తావన 	(Prastāvana)	
menu 	 మెను 	(Menu)	
mere 	 కేవలం 	(Kēvalaṁ)	
merely 	 కేవలం 	(Kēvalaṁ)	
mess 	 గజిబిజి 	(Gajibiji)	
message 	 సందేశం 	(Sandēśaṁ)	
metal 	 మెటల్ 	(Meṭal)	
method 	 పద్ధతి 	(Pad'dhati)	
metre 	 మీటర్ 	(Mīṭar)	
mid- 	 మధ్య 	(Madhya)	
midday 	 మధ్యాహ్నము 	(Madhyāhnamu)	
middle 	 మధ్య 	(Madhya)	
midnight 	 అర్ధరాత్రి 	(Ardharātri)	
might 	 ఉండవచ్చు 	(Uṇḍavaccu)	
mild 	 తేలికపాటి 	(Tēlikapāṭi)	
mile 	 మైలు 	(Mailu)	
military 	 సైనిక 	(Sainika)	
milk 	 పాలు 	(Pālu)	
milligram 	 మిల్లీగ్రాము 	(Millīgrāmu)	
millimetre 	 మిల్లీమీటర్ 	(Millīmīṭar)	
million 	 మిలియన్ 	(Miliyan)	
millionth 	 మిలియన్ 	(Miliyan)	
mind 	 మనసు 	(Manasu)	
mine 	 నాది 	(Nādi)	
mineral 	 ఖనిజ 	(Khanija)	
minimum 	 కనీస 	(Kanīsa)	
minister 	 మంత్రి 	(Mantri)	
ministry 	 మంత్రిత్వ శాఖ 	(Mantritva śākha)	
minor 	 మైనర్ 	(Mainar)	
minority 	 మైనారిటీ 	(Maināriṭī)	
minute 1 	 నిమిషం 1 	(Nimiṣaṁ 1)	
mirror 	 అద్దం 	(Addaṁ)	
miss 	 మిస్ 	(Mis)	
missing 	 లేదు 	(Lēdu)	
miss out 	 మిస్ 	(Mis)	
mistake 	 పొరపాటు 	(Porapāṭu)	
mistake for 	 కోసం పొరపాటు 	(Kōsaṁ porapāṭu)	
mistaken 	 పొరబడ్డాను 	(Porabaḍḍānu)	
mix 	 కలపాలి 	(Kalapāli)	
mixed 	 మిశ్రమ 	(Miśrama)	
mixture 	 మిశ్రమం 	(Miśramaṁ)	
mix up 	 కలపాలి 	(Kalapāli)	
mobile 	 మొబైల్ 	(Mobail)	
mobile phone 	 మొబైల్ ఫోన్ 	(Mobail phōn)	
model 	 మోడల్ 	(Mōḍal)	
modern 	 ఆధునిక 	(Ādhunika)	
mom 	 అమ్మ 	(Am'ma)	
moment 	 క్షణం 	(Kṣaṇaṁ)	
Monday 	 సోమవారం 	(Sōmavāraṁ)	
money 	 డబ్బు 	(Ḍabbu)	
monitor 	 మానిటర్ 	(Māniṭar)	
month 	 నెల 	(Nela)	
mood 	 మానసిక స్థితి 	(Mānasika sthiti)	
moon 	 చంద్రుడు 	(Candruḍu)	
moral 	 నైతిక 	(Naitika)	
morally 	 నైతికంగా 	(Naitikaṅgā)	
more 	 మరింత 	(Marinta)	
moreover 	 పైగా 	(Paigā)	
morning 	 ఉదయం 	(Udayaṁ)	
most 	 అత్యంత 	(Atyanta)	
mostly 	 ఎక్కువగా 	(Ekkuvagā)	
mother 	 తల్లి 	(Talli)	
motion 	 చలనం 	(Calanaṁ)	
motor 	 మోటార్ 	(Mōṭār)	
motorbike 	 మోటార్ బైక్ 	(Mōṭār baik)	
motorcycle 	 మోటార్ సైకిల్ 	(Mōṭār saikil)	
mount 	 మౌంట్ 	(Mauṇṭ)	
mountain 	 పర్వతం 	(Parvataṁ)	
mouse 	 మౌస్ 	(Maus)	
mouth 	 నోరు 	(Nōru)	
move 	 తరలించు 	(Taralin̄cu)	
move in 	 లోపలికి వెళ్లండి 	(Lōpaliki veḷlaṇḍi)	
movement 	 ఉద్యమం 	(Udyamaṁ)	
move out 	 బయటకు తరలించు 	(Bayaṭaku taralin̄cu)	
move over 	 పైగా తరలించు 	(Paigā taralin̄cu)	
movie 	 సినిమా 	(Sinimā)	
movie theater 	 సినిమా థియేటర్ 	(Sinimā thiyēṭar)	
moving 	 కదులుతోంది 	(Kadulutōndi)	
Mr 	 Mr 	(Mr)	
Mrs 	 శ్రీమతి 	(Śrīmati)	
Ms 	 శ్రీమతి 	(Śrīmati)	
much 	 చాలా 	(Cālā)	
mud 	 బురద 	(Burada)	
multiply 	 గుణించాలి 	(Guṇin̄cāli)	
mum 	 అమ్మ 	(Am'ma)	
murder 	 హత్య 	(Hatya)	
muscle 	 కండరము 	(Kaṇḍaramu)	
museum 	 మ్యూజియం 	(Myūjiyaṁ)	
music 	 సంగీతం 	(Saṅgītaṁ)	
musical 	 సంగీతపరమైన 	(Saṅgītaparamaina)	
musician 	 సంగీతకారుడు 	(Saṅgītakāruḍu)	
must 	 తప్పక 	(Tappaka)	
my 	 నా 	(Nā)	
myself 	 నేనే 	(Nēnē)	
mysterious 	 రహస్యమైన 	(Rahasyamaina)	
mystery 	 రహస్యం 	(Rahasyaṁ)	
nail 	 గోరు 	(Gōru)	
naked 	 నగ్నంగా 	(Nagnaṅgā)	
name 	 పేరు 	(Pēru)	
narrow 	 ఇరుకైనది 	(Irukainadi)	
nation 	 దేశం 	(Dēśaṁ)	
national 	 జాతీయ 	(Jātīya)	
natural 	 సహజమైన 	(Sahajamaina)	
naturally 	 సహజంగా 	(Sahajaṅgā)	
nature 	 ప్రకృతి 	(Prakr̥ti)	
navy 	 నౌకాదళం 	(Naukādaḷaṁ)	
near 	 సమీపంలో 	(Samīpanlō)	
nearby 	 సమీపంలో 	(Samīpanlō)	
nearly 	 దాదాపు 	(Dādāpu)	
neat 	 చక్కగా 	(Cakkagā)	
neatly 	 చక్కగా 	(Cakkagā)	
necessarily 	 తప్పనిసరిగా 	(Tappanisarigā)	
necessary 	 అవసరమైన 	(Avasaramaina)	
neck 	 మెడ 	(Meḍa)	
need 	 అవసరం 	(Avasaraṁ)	
needle 	 సూది 	(Sūdi)	
negative 	 ప్రతికూల 	(Pratikūla)	
neighbour 	 పొరుగు 	(Porugu)	
neighbourhood 	 పొరుగు 	(Porugu)	
neither 	 కాదు 	(Kādu)	
nephew 	 మేనల్లుడు 	(Mēnalluḍu)	
nerve 	 నరము 	(Naramu)	
nervous 	 నాడీ 	(Nāḍī)	
nervously 	 భయంగా 	(Bhayaṅgā)	
nest 	 గూడు 	(Gūḍu)	
net 	 నికర 	(Nikara)	
network 	 నెట్వర్క్ 	(Neṭvark)	
never 	 ఎప్పుడూ 	(Eppuḍū)	
nevertheless 	 అయినప్పటికీ 	(Ayinappaṭikī)	
new 	 కొత్త 	(Kotta)	
newly 	 కొత్తగా 	(Kottagā)	
news 	 వార్తలు 	(Vārtalu)	
newspaper 	 వార్తాపత్రిక 	(Vārtāpatrika)	
next 	 తదుపరి 	(Tadupari)	
next to 	 పక్కన 	(Pakkana)	
nice 	 బాగుంది 	(Bāgundi)	
nicely 	 చక్కగా 	(Cakkagā)	
niece 	 మేనకోడలు 	(Mēnakōḍalu)	
night 	 రాత్రి 	(Rātri)	
nine 	 తొమ్మిది 	(Tom'midi)	
nineteen 	 పంతొమ్మిది 	(Pantom'midi)	
nineteenth 	 పంతొమ్మిదవ 	(Pantom'midava)	
ninetieth 	 తొంభైవది 	(Tombhaivadi)	
ninety 	 తొంభై 	(Tombhai)	
ninth 	 తొమ్మిదవ 	(Tom'midava)	
no 	 లేదు 	(Lēdu)	
nobody 	 ఎవరూ 	(Evarū)	
noise 	 శబ్దం 	(Śabdaṁ)	
noisily 	 సందడిగా 	(Sandaḍigā)	
noisy 	 సందడి 	(Sandaḍi)	
non- 	 కాని 	(Kāni)	
none 	 ఏదీ లేదు 	(Ēdī lēdu)	
nonsense 	 అర్ధంలేనిది 	(Ardhanlēnidi)	
no one 	 ఎవరూ 	(Evarū)	
nor 	 లేదా 	(Lēdā)	
normal 	 సాధారణ 	(Sādhāraṇa)	
normally 	 సాధారణంగా 	(Sādhāraṇaṅgā)	
north 	 ఉత్తరం 	(Uttaraṁ)	
northern 	 ఉత్తరాది 	(Uttarādi)	
nose 	 ముక్కు 	(Mukku)	
not 	 కాదు 	(Kādu)	
note 	 గమనించండి 	(Gamanin̄caṇḍi)	
note down 	 గమనించండి 	(Gamanin̄caṇḍi)	
nothing 	 ఏమీ లేదు 	(Ēmī lēdu)	
notice 	 నోటీసు 	(Nōṭīsu)	
noticeable 	 గమనించదగినది 	(Gamanin̄cadaginadi)	
novel 	 నవల 	(Navala)	
November 	 నవంబర్ 	(Navambar)	
now 	 ఇప్పుడు 	(Ippuḍu)	
nowhere 	 ఎక్కడా లేదు 	(Ekkaḍā lēdu)	
nuclear 	 అణు 	(Aṇu)	
number 	 సంఖ్య 	(Saṅkhya)	
nurse 	 నర్సు 	(Narsu)	
nut 	 గింజ 	(Gin̄ja)	
obey 	 పాటించండి 	(Pāṭin̄caṇḍi)	
object 	 వస్తువు 	(Vastuvu)	
objective 	 లక్ష్యం 	(Lakṣyaṁ)	
observation 	 పరిశీలన 	(Pariśīlana)	
observe 	 గమనించండి 	(Gamanin̄caṇḍi)	
obtain 	 పొందండి 	(Pondaṇḍi)	
obvious 	 స్పష్టమైన 	(Spaṣṭamaina)	
obviously 	 స్పష్టంగా 	(Spaṣṭaṅgā)	
occasion 	 సందర్భం 	(Sandarbhaṁ)	
occasionally 	 అప్పుడప్పుడు 	(Appuḍappuḍu)	
occupied 	 ఆక్రమించుకున్నారు 	(Ākramin̄cukunnāru)	
occupy 	 ఆక్రమిస్తాయి 	(Ākramistāyi)	
occur 	 సంభవిస్తాయి 	(Sambhavistāyi)	
occur to 	 ఏర్పడుతుంది 	(Ērpaḍutundi)	
ocean 	 సముద్రం 	(Samudraṁ)	
o’clock 	 గంట 	(Gaṇṭa)	
October 	 అక్టోబర్ 	(Akṭōbar)	
odd 	 బేసి 	(Bēsi)	
oddly 	 విచిత్రంగా 	(Vicitraṅgā)	
of 	 యొక్క 	(Yokka)	
off 	 ఆఫ్ 	(Āph)	
offence 	 నేరం 	(Nēraṁ)	
offend 	 నేరం 	(Nēraṁ)	
offense 	 నేరం 	(Nēraṁ)	
offensive 	 ప్రమాదకర 	(Pramādakara)	
offer 	 ఆఫర్ 	(Āphar)	
office 	 కార్యాలయం 	(Kāryālayaṁ)	
officer 	 అధికారి 	(Adhikāri)	
official 	 అధికారిక 	(Adhikārika)	
officially 	 అధికారికంగా 	(Adhikārikaṅgā)	
often 	 తరచుగా 	(Taracugā)	
oh 	 ఓహ్ 	(Ōh)	
oil 	 నూనె 	(Nūne)	
OK 	 సరే 	(Sarē)	
old 	 పాతది 	(Pātadi)	
old-fashioned 	 పాతకాలపు 	(Pātakālapu)	
on 	 న 	(Na)	
once 	 ఒకసారి 	(Okasāri)	
one 	 ఒకటి 	(Okaṭi)	
one another 	 ఒకరినొకరు 	(Okarinokaru)	
onion 	 ఉల్లిపాయ 	(Ullipāya)	
online 	 ఆన్లైన్ 	(Ānlain)	
only 	 మాత్రమే 	(Mātramē)	
onto 	 పై 	(Pai)	
open 	 తెరవండి 	(Teravaṇḍi)	
opening 	 తెరవడం 	(Teravaḍaṁ)	
openly 	 బహిరంగంగా 	(Bahiraṅgaṅgā)	
open up 	 తెరవండి 	(Teravaṇḍi)	
operate 	 పనిచేస్తాయి 	(Panicēstāyi)	
operation 	 ఆపరేషన్ 	(Āparēṣan)	
opinion 	 అభిప్రాయం 	(Abhiprāyaṁ)	
opponent 	 ప్రత్యర్థి 	(Pratyarthi)	
opportunity 	 అవకాశం 	(Avakāśaṁ)	
oppose 	 వ్యతిరేకించండి 	(Vyatirēkin̄caṇḍi)	
opposed 	 వ్యతిరేకించారు 	(Vyatirēkin̄cāru)	
opposing 	 వ్యతిరేకిస్తున్నారు 	(Vyatirēkistunnāru)	
opposite 	 ఎదురుగా 	(Edurugā)	
opposition 	 వ్యతిరేకత 	(Vyatirēkata)	
option 	 ఎంపిక 	(Empika)	
or 	 లేదా 	(Lēdā)	
orange 	 నారింజ 	(Nārin̄ja)	
order 	 ఆర్డర్ 	(Ārḍar)	
ordinary 	 సాధారణ 	(Sādhāraṇa)	
organ 	 అవయవం 	(Avayavaṁ)	
organization 	 సంస్థ 	(Sanstha)	
organize 	 నిర్వహించండి 	(Nirvahin̄caṇḍi)	
organized 	 నిర్వహించారు 	(Nirvahin̄cāru)	
origin 	 మూలం 	(Mūlaṁ)	
original 	 అసలు 	(Asalu)	
originally 	 అసలైన 	(Asalaina)	
other 	 ఇతర 	(Itara)	
otherwise 	 లేకుంటే 	(Lēkuṇṭē)	
ought to 	 తప్పక 	(Tappaka)	
our 	 మా 	(Mā)	
ours 	 మాది 	(Mādi)	
ourselves 	 మనమే 	(Manamē)	
out 	 బయటకు 	(Bayaṭaku)	
outdoor 	 బాహ్య 	(Bāhya)	
outdoors 	 ఆరుబయట 	(Ārubayaṭa)	
outer 	 బయటి 	(Bayaṭi)	
outline 	 రూపురేఖలు 	(Rūpurēkhalu)	
output 	 అవుట్పుట్ 	(Avuṭpuṭ)	
outside 	 బయట 	(Bayaṭa)	
outstanding 	 అత్యుత్తమమైనది 	(Atyuttamamainadi)	
oven 	 పొయ్యి 	(Poyyi)	
over 	 పైగా 	(Paigā)	
overall 	 మొత్తం 	(Mottaṁ)	
overcome 	 అధిగమించడానికి 	(Adhigamin̄caḍāniki)	
owe 	 ఋణపడి ఉన్నారు 	(R̥ṇapaḍi unnāru)	
own 	 స్వంతం 	(Svantaṁ)	
owner 	 యజమాని 	(Yajamāni)	
own up 	 సొంతం చేసుకుంటారు 	(Sontaṁ cēsukuṇṭāru)	
pace 1 	 పేస్ 1 	(Pēs 1)	
pack 	 ప్యాక్ 	(Pyāk)	
package 	 ప్యాకేజీ 	(Pyākējī)	
packaging 	 ప్యాకేజింగ్ 	(Pyākējiṅg)	
packet 	 ప్యాకెట్ 	(Pyākeṭ)	
pack up 	 సర్దుకోండి 	(Sardukōṇḍi)	
page 	 పేజీ 	(Pējī)	
pain 	 నొప్పి 	(Noppi)	
painful 	 బాధాకరమైన 	(Bādhākaramaina)	
paint 	 పెయింట్ 	(Peyiṇṭ)	
painter 	 చిత్రకారుడు 	(Citrakāruḍu)	
painting 	 పెయింటింగ్ 	(Peyiṇṭiṅg)	
pair 	 జత 	(Jata)	
palace 	 రాజభవనం 	(Rājabhavanaṁ)	
pale 	 లేత 	(Lēta)	
pan 1 	 పాన్ 1 	(Pān 1)	
panel 	 ప్యానెల్ 	(Pyānel)	
pants 	 ప్యాంటు 	(Pyāṇṭu)	
paper 	 కాగితం 	(Kāgitaṁ)	
parallel 	 సమాంతరంగా 	(Samāntaraṅgā)	
parent 	 తల్లిదండ్రులు 	(Tallidaṇḍrulu)	
park 	 పార్క్ 	(Pārk)	
parliament 	 పార్లమెంటు 	(Pārlameṇṭu)	
part 	 భాగం 	(Bhāgaṁ)	
particular 	 ప్రత్యేకంగా 	(Pratyēkaṅgā)	
particularly 	 ముఖ్యంగా 	(Mukhyaṅgā)	
partly 	 పాక్షికంగా 	(Pākṣikaṅgā)	
partner 	 భాగస్వామి 	(Bhāgasvāmi)	
partnership 	 భాగస్వామ్యం 	(Bhāgasvāmyaṁ)	
party 	 పార్టీ 	(Pārṭī)	
pass 	 పాస్ 	(Pās)	
passage 	 ప్రకరణము 	(Prakaraṇamu)	
pass away 	 గతించు 	(Gatin̄cu)	
pass by 	 దాటి వెళ్ళు 	(Dāṭi veḷḷu)	
passenger 	 ప్రయాణీకుడు 	(Prayāṇīkuḍu)	
passing 	 ఉత్తీర్ణత 	(Uttīrṇata)	
pass on 	 పాస్ 	(Pās)	
pass out 	 పాస్ అవుట్ 	(Pās avuṭ)	
passport 	 పాస్పోర్ట్ 	(Pāspōrṭ)	
pass round 	 రౌండ్ పాస్ 	(Rauṇḍ pās)	
pass through 	 గుండా 	(Guṇḍā)	
past 	 గత 	(Gata)	
path 	 మార్గం 	(Mārgaṁ)	
patience 	 సహనం 	(Sahanaṁ)	
patient 	 రోగి 	(Rōgi)	
pattern 	 నమూనా 	(Namūnā)	
pause 	 విరామం 	(Virāmaṁ)	
pay 	 చెల్లించాలి 	(Cellin̄cāli)	
pay back 	 తిరిగి చెల్లించు 	(Tirigi cellin̄cu)	
payment 	 చెల్లింపు 	(Cellimpu)	
pay out 	 చెల్లించండి 	(Cellin̄caṇḍi)	
pay up 	 చెల్లించండి 	(Cellin̄caṇḍi)	
peace 	 శాంతి 	(Śānti)	
peaceful 	 శాంతియుతమైనది 	(Śāntiyutamainadi)	
peak 	 శిఖరం 	(Śikharaṁ)	
pen 	 కలం 	(Kalaṁ)	
pencil 	 పెన్సిల్ 	(Pensil)	
penny 	 పెన్నీ 	(Pennī)	
pension 1 	 పెన్షన్ 1 	(Penṣan 1)	
people 	 ప్రజలు 	(Prajalu)	
pepper 	 మిరియాలు 	(Miriyālu)	
per 	 ప్రతి 	(Prati)	
per cent 	 శాతం 	(Śātaṁ)	
perfect 	 పరిపూర్ణమైనది 	(Paripūrṇamainadi)	
perfectly 	 సంపూర్ణంగా 	(Sampūrṇaṅgā)	
perform 	 నిర్వహిస్తారు 	(Nirvahistāru)	
performance 	 పనితీరు 	(Panitīru)	
performer 	 ప్రదర్శకుడు 	(Pradarśakuḍu)	
perhaps 	 బహుశా 	(Bahuśā)	
period 	 కాలం 	(Kālaṁ)	
permanent 	 శాశ్వత 	(Śāśvata)	
permanently 	 శాశ్వతంగా 	(Śāśvataṅgā)	
permission 	 అనుమతి 	(Anumati)	
permit 	 అనుమతి 	(Anumati)	
person 	 వ్యక్తి 	(Vyakti)	
personal 	 వ్యక్తిగత 	(Vyaktigata)	
personality 	 వ్యక్తిత్వం 	(Vyaktitvaṁ)	
personally 	 వ్యక్తిగతంగా 	(Vyaktigataṅgā)	
persuade 	 ఒప్పించండి 	(Oppin̄caṇḍi)	
pet 	 పెంపుడు జంతువు 	(Pempuḍu jantuvu)	
petrol 	 పెట్రోల్ 	(Peṭrōl)	
phase 	 దశ 	(Daśa)	
philosophy 	 తత్వశాస్త్రం 	(Tatvaśāstraṁ)	
phone 	 ఫోన్ 	(Phōn)	
photo 	 ఫోటో 	(Phōṭō)	
photocopy 	 ఫోటోకాపీ 	(Phōṭōkāpī)	
photograph 	 ఫోటో 	(Phōṭō)	
photographer 	 ఫోటోగ్రాఫర్ 	(Phōṭōgrāphar)	
photography 	 ఫోటోగ్రఫీ 	(Phōṭōgraphī)	
phrase 	 పదబంధం 	(Padabandhaṁ)	
physical 	 భౌతిక 	(Bhautika)	
physically 	 భౌతికంగా 	(Bhautikaṅgā)	
physics 	 భౌతిక శాస్త్రం 	(Bhautika śāstraṁ)	
piano 	 పియానో 	(Piyānō)	
pick 	 ఎంచుకోండి 	(En̄cukōṇḍi)	
pick up 	 తీయండి 	(Tīyaṇḍi)	
picture 	 చిత్రం 	(Citraṁ)	
piece 	 ముక్క 	(Mukka)	
pig 	 పంది 	(Pandi)	
pile 	 కుప్ప 	(Kuppa)	
pile up 	 పోగు 	(Pōgu)	
pill 	 మాత్ర 	(Mātra)	
pilot 	 పైలట్ 	(Pailaṭ)	
pin 	 పిన్ 	(Pin)	
pink 	 గులాబీ రంగు 	(Gulābī raṅgu)	
pint 	 పింట్ 	(Piṇṭ)	
pipe 	 పైపు 	(Paipu)	
pitch 	 పిచ్ 	(Pic)	
pity 	 జాలి 	(Jāli)	
place 	 స్థలం 	(Sthalaṁ)	
plain 	 సాదా 	(Sādā)	
plan 	 ప్రణాళిక 	(Praṇāḷika)	
plane 	 విమానం 	(Vimānaṁ)	
planet 	 గ్రహం 	(Grahaṁ)	
planning 	 ప్రణాళిక 	(Praṇāḷika)	
plant 	 మొక్క 	(Mokka)	
plastic 	 ప్లాస్టిక్ 	(Plāsṭik)	
plate 	 ప్లేట్ 	(Plēṭ)	
platform 	 వేదిక 	(Vēdika)	
play 	 ఆడండి 	(Āḍaṇḍi)	
play about 	 గురించి ప్లే 	(Gurin̄ci plē)	
player 	 ఆటగాడు 	(Āṭagāḍu)	
play with 	 తో ఆడుకోండి 	(Tō āḍukōṇḍi)	
pleasant 	 ఆహ్లాదకరమైన 	(Āhlādakaramaina)	
pleasantly 	 ఆహ్లాదకరంగా 	(Āhlādakaraṅgā)	
please 	 దయచేసి 	(Dayacēsi)	
pleased 	 సంతోషించారు 	(Santōṣin̄cāru)	
pleasing 	 ఆహ్లాదకరమైన 	(Āhlādakaramaina)	
pleasure 	 ఆనందం 	(Ānandaṁ)	
plenty 	 పుష్కలంగా 	(Puṣkalaṅgā)	
plot 	 ప్లాట్లు 	(Plāṭlu)	
plug 	 ప్లగ్ 	(Plag)	
plug in 	 ప్లగ్ ఇన్ చేయండి 	(Plag in cēyaṇḍi)	
plus 1 	 ప్లస్ 1 	(Plas 1)	
p.m. 	 p.m. 	(P.M.)	
pocket 	 జేబు 	(Jēbu)	
poem 	 పద్యం 	(Padyaṁ)	
poetry 	 కవిత్వం 	(Kavitvaṁ)	
point 	 పాయింట్ 	(Pāyiṇṭ)	
pointed 	 ఎత్తి చూపారు 	(Etti cūpāru)	
point out 	 ఎత్తి చూపుతారు 	(Etti cūputāru)	
poison 	 విషం 	(Viṣaṁ)	
poisonous 	 విషపూరితమైన 	(Viṣapūritamaina)	
pole 	 పోల్ 	(Pōl)	
police 	 పోలీసు 	(Pōlīsu)	
policy 	 విధానం 	(Vidhānaṁ)	
polish 	 పాలిష్ 	(Pāliṣ)	
polite 	 మర్యాదపూర్వకమైన 	(Maryādapūrvakamaina)	
politely 	 మర్యాదగా 	(Maryādagā)	
political 	 రాజకీయ 	(Rājakīya)	
politically 	 రాజకీయంగా 	(Rājakīyaṅgā)	
politician 	 రాజకీయ నాయకుడు 	(Rājakīya nāyakuḍu)	
politics 	 రాజకీయాలు 	(Rājakīyālu)	
pollution 	 కాలుష్యం 	(Kāluṣyaṁ)	
pool 	 కొలను 	(Kolanu)	
poor 	 పేదవాడు 	(Pēdavāḍu)	
pop 	 పాప్ 	(Pāp)	
popular 	 ప్రజాదరణ పొందింది 	(Prajādaraṇa pondindi)	
population 	 జనాభా 	(Janābhā)	
port 	 ఓడరేవు 	(Ōḍarēvu)	
pose 	 భంగిమలో 	(Bhaṅgimalō)	
position 	 స్థానం 	(Sthānaṁ)	
positive 	 సానుకూల 	(Sānukūla)	
possess 	 కలిగి ఉంటాయి 	(Kaligi uṇṭāyi)	
possession 	 స్వాధీనం 	(Svādhīnaṁ)	
possibility 	 అవకాశం 	(Avakāśaṁ)	
possible 	 సాధ్యం 	(Sādhyaṁ)	
possibly 	 బహుశా 	(Bahuśā)	
post 	 పోస్ట్ 	(Pōsṭ)	
post office 	 పోస్టాఫీసు 	(Pōsṭāphīsu)	
pot 	 కుండ 	(Kuṇḍa)	
potato 	 బంగాళదుంప 	(Baṅgāḷadumpa)	
potential 	 సంభావ్య 	(Sambhāvya)	
potentially 	 సంభావ్యంగా 	(Sambhāvyaṅgā)	
pound 	 పౌండ్ 	(Pauṇḍ)	
pour 	 పోయాలి 	(Pōyāli)	
powder 	 పొడి 	(Poḍi)	
power 	 శక్తి 	(Śakti)	
powerful 	 శక్తివంతమైన 	(Śaktivantamaina)	
practical 	 ఆచరణాత్మకమైనది 	(Ācaraṇātmakamainadi)	
practically 	 ఆచరణాత్మకంగా 	(Ācaraṇātmakaṅgā)	
practice 	 సాధన 	(Sādhana)	
practise 	 సాధన 	(Sādhana)	
praise 	 ప్రశంసలు 	(Praśansalu)	
pray 	 ప్రార్థించండి 	(Prārthin̄caṇḍi)	
prayer 	 ప్రార్థన 	(Prārthana)	
precise 	 ఖచ్చితమైన 	(Khaccitamaina)	
precisely 	 ఖచ్చితంగా 	(Khaccitaṅgā)	
predict 	 అంచనా వేయండి 	(An̄canā vēyaṇḍi)	
prefer 	 ఇష్టపడతారు 	(Iṣṭapaḍatāru)	
preference 	 ప్రాధాన్యత 	(Prādhān'yata)	
pregnant 	 గర్భవతి 	(Garbhavati)	
premises 	 ప్రాంగణంలో 	(Prāṅgaṇanlō)	
preparation 	 తయారీ 	(Tayārī)	
prepare 	 సిద్ధం 	(Sid'dhaṁ)	
prepared 	 సిద్ధం 	(Sid'dhaṁ)	
presence 	 ఉనికిని 	(Unikini)	
present 	 ప్రస్తుతం 	(Prastutaṁ)	
presentation 	 ప్రదర్శన 	(Pradarśana)	
preserve 	 సంరక్షించు 	(Sanrakṣin̄cu)	
president 	 అధ్యక్షుడు 	(Adhyakṣuḍu)	
press 	 నొక్కండి 	(Nokkaṇḍi)	
pressure 	 ఒత్తిడి 	(Ottiḍi)	
presumably 	 బహుశా 	(Bahuśā)	
pretend 	 నటిస్తారు 	(Naṭistāru)	
pretty 	 అందంగా 	(Andaṅgā)	
prevent 	 నిరోధిస్తాయి 	(Nirōdhistāyi)	
previous 	 మునుపటి 	(Munupaṭi)	
previously 	 గతంలో 	(Gatanlō)	
price 	 ధర 	(Dhara)	
pride 	 గర్వం 	(Garvaṁ)	
priest 	 పూజారి 	(Pūjāri)	
primarily 	 ప్రధానంగా 	(Pradhānaṅgā)	
primary 	 ప్రాథమిక 	(Prāthamika)	
prime minister 	 ప్రధాన మంత్రి 	(Pradhāna mantri)	
prince 	 యువరాజు 	(Yuvarāju)	
princess 	 యువరాణి 	(Yuvarāṇi)	
principle 	 సూత్రం 	(Sūtraṁ)	
print 	 ప్రింట్ 	(Priṇṭ)	
printer 	 ప్రింటర్ 	(Priṇṭar)	
printing 	 ప్రింటింగ్ 	(Priṇṭiṅg)	
print off 	 ప్రింట్ ఆఫ్ 	(Priṇṭ āph)	
prior 	 ముందు 	(Mundu)	
priority 	 ప్రాధాన్యత 	(Prādhān'yata)	
prison 	 జైలు 	(Jailu)	
prisoner 	 ఖైదీ 	(Khaidī)	
private 	 ప్రైవేట్ 	(Praivēṭ)	
privately 	 ప్రైవేట్u200cగా 	(Praivēṭu200cgā)	
prize 	 బహుమతి 	(Bahumati)	
probable 	 సంభావ్య 	(Sambhāvya)	
probably 	 బహుశా 	(Bahuśā)	
problem 	 సమస్య 	(Samasya)	
procedure 	 ప్రక్రియ 	(Prakriya)	
proceed 	 కొనసాగండి 	(Konasāgaṇḍi)	
process 1 	 ప్రక్రియ 1 	(Prakriya 1)	
produce 	 ఉత్పత్తి చేస్తాయి 	(Utpatti cēstāyi)	
producer 	 నిర్మాత 	(Nirmāta)	
product 	 ఉత్పత్తి 	(Utpatti)	
production 	 ఉత్పత్తి 	(Utpatti)	
profession 	 వృత్తి 	(Vr̥tti)	
professional 	 వృత్తిపరమైన 	(Vr̥ttiparamaina)	
professor 	 ప్రొఫెసర్ 	(Prophesar)	
profit 	 లాభం 	(Lābhaṁ)	
program 	 కార్యక్రమం 	(Kāryakramaṁ)	
programme 	 కార్యక్రమం 	(Kāryakramaṁ)	
progress 	 పురోగతి 	(Purōgati)	
project 	 ప్రాజెక్ట్ 	(Prājekṭ)	
promise 	 వాగ్దానం 	(Vāgdānaṁ)	
promote 	 ప్రచారం చేయండి 	(Pracāraṁ cēyaṇḍi)	
promotion 	 ప్రమోషన్ 	(Pramōṣan)	
prompt 	 ప్రాంప్ట్ 	(Prāmpṭ)	
promptly 	 వెంటనే 	(Veṇṭanē)	
pronounce 	 పలుకుతారు 	(Palukutāru)	
pronunciation 	 ఉచ్చారణ 	(Uccāraṇa)	
proof 	 రుజువు 	(Rujuvu)	
proper 	 సరైన 	(Saraina)	
properly 	 సరిగ్గా 	(Sariggā)	
property 	 ఆస్తి 	(Āsti)	
proportion 	 నిష్పత్తి 	(Niṣpatti)	
proposal 	 ప్రతిపాదన 	(Pratipādana)	
propose 	 ప్రతిపాదించండి 	(Pratipādin̄caṇḍi)	
prospect 	 అవకాశం 	(Avakāśaṁ)	
protect 	 రక్షించండి 	(Rakṣin̄caṇḍi)	
protection 	 రక్షణ 	(Rakṣaṇa)	
protest 	 నిరసన 	(Nirasana)	
proud 	 గర్వంగా ఉంది 	(Garvaṅgā undi)	
proudly 	 గర్వంగా 	(Garvaṅgā)	
prove 	 నిరూపించండి 	(Nirūpin̄caṇḍi)	
provide 	 అందిస్తాయి 	(Andistāyi)	
provided 	 అందించారు 	(Andin̄cāru)	
providing 	 అందించడం 	(Andin̄caḍaṁ)	
pub 	 పబ్ 	(Pab)	
public 	 పబ్లిక్ 	(Pablik)	
publication 	 ప్రచురణ 	(Pracuraṇa)	
publicity 	 ప్రచారం 	(Pracāraṁ)	
publicly 	 బహిరంగంగా 	(Bahiraṅgaṅgā)	
publish 	 ప్రచురించండి 	(Pracurin̄caṇḍi)	
publishing 	 ప్రచురించడం 	(Pracurin̄caḍaṁ)	
pull 	 లాగండి 	(Lāgaṇḍi)	
pull apart 	 వేరుగా లాగండి 	(Vērugā lāgaṇḍi)	
pull down 	 క్రిందికి లాగండి 	(Krindiki lāgaṇḍi)	
pull in 	 లోపలికి లాగండి 	(Lōpaliki lāgaṇḍi)	
pull off 	 లాగండి 	(Lāgaṇḍi)	
pull out 	 బయటకు లాగండి 	(Bayaṭaku lāgaṇḍi)	
pull over 	 పైకి లాగండి 	(Paiki lāgaṇḍi)	
pull through 	 ద్వారా లాగండి 	(Dvārā lāgaṇḍi)	
pull together 	 కలిసి లాగండి 	(Kalisi lāgaṇḍi)	
pull up 	 పైకి లాగండి 	(Paiki lāgaṇḍi)	
punch 	 పంచ్ 	(Pan̄c)	
punish 	 శిక్షించండి 	(Śikṣin̄caṇḍi)	
punishment 	 శిక్ష 	(Śikṣa)	
pupil 	 విద్యార్థి 	(Vidyārthi)	
purchase 	 కొనుగోలు 	(Konugōlu)	
pure 	 స్వచ్ఛమైన 	(Svacchamaina)	
purely 	 పూర్తిగా 	(Pūrtigā)	
purple 	 ఊదా రంగు 	(Ūdā raṅgu)	
purpose 	 ప్రయోజనం 	(Prayōjanaṁ)	
pursue 	 కొనసాగించు 	(Konasāgin̄cu)	
push 	 పుష్ 	(Puṣ)	
push about 	 గురించి పుష్ 	(Gurin̄ci puṣ)	
push forward 	 ముందుకు నెట్టండి 	(Munduku neṭṭaṇḍi)	
put 	 చాలు 	(Cālu)	
put away 	 దూరంగా ఉంచారు 	(Dūraṅgā un̄cāru)	
put back 	 తిరిగి చాలు 	(Tirigi cālu)	
put down 	 దించేశాడు 	(Din̄cēśāḍu)	
put forward 	 ముందుంచారు 	(Mundun̄cāru)	
put in 	 పెట్టింది 	(Peṭṭindi)	
put off 	 నిలిపివేసింది 	(Nilipivēsindi)	
put on 	 చాలు 	(Cālu)	
put out 	 బయట పెట్టాడు 	(Bayaṭa peṭṭāḍu)	
put through 	 ద్వారా చాలు 	(Dvārā cālu)	
put together 	 కలిసి ఉంచారు 	(Kalisi un̄cāru)	
put up 	 చాలు 	(Cālu)	
put up with 	 తో పెట్టాడు 	(Tō peṭṭāḍu)	
qualification 	 అర్హత 	(Ar'hata)	
qualified 	 అర్హత సాధించారు 	(Ar'hata sādhin̄cāru)	
qualify 	 అర్హత 	(Ar'hata)	
quality 	 నాణ్యత 	(Nāṇyata)	
quantity 	 పరిమాణం 	(Parimāṇaṁ)	
quarter 	 త్రైమాసికం 	(Traimāsikaṁ)	
queen 	 రాణి 	(Rāṇi)	
question 	 ప్రశ్న 	(Praśna)	
quick 	 త్వరగా 	(Tvaragā)	
quickly 	 త్వరగా 	(Tvaragā)	
quiet 	 నిశ్శబ్దంగా 	(Niśśabdaṅgā)	
quietly 	 నిశ్శబ్దంగా 	(Niśśabdaṅgā)	
quit 	 విడిచిపెట్టు 	(Viḍicipeṭṭu)	
quite 	 చాలా 	(Cālā)	
quote 	 కోట్ 	(Kōṭ)	
race 	 జాతి 	(Jāti)	
racing 	 రేసింగ్ 	(Rēsiṅg)	
radio 	 రేడియో 	(Rēḍiyō)	
rail 	 రైలు 	(Railu)	
railroad 	 రైలుమార్గం 	(Railumārgaṁ)	
railway 	 రైల్వే 	(Railvē)	
rain 	 వర్షం 	(Varṣaṁ)	
raise 	 పెంచండి 	(Pen̄caṇḍi)	
range 	 పరిధి 	(Paridhi)	
rank 	 ర్యాంక్ 	(Ryāṅk)	
rapid 	 వేగవంతమైన 	(Vēgavantamaina)	
rapidly 	 వేగంగా 	(Vēgaṅgā)	
rare 	 అరుదైన 	(Arudaina)	
rarely 	 అరుదుగా 	(Arudugā)	
rate 	 రేటు 	(Rēṭu)	
rather 	 కాకుండా 	(Kākuṇḍā)	
raw 	 ముడి 	(Muḍi)	
re- 	 తిరిగి- 	(Tirigi-)	
reach 	 చేరుకుంటాయి 	(Cērukuṇṭāyi)	
react 	 ప్రతిస్పందిస్తాయి 	(Pratispandistāyi)	
reaction 	 ప్రతిచర్య 	(Praticarya)	
read 	 చదివాడు 	(Cadivāḍu)	
reader 	 పాఠకుడు 	(Pāṭhakuḍu)	
reading 	 చదవడం 	(Cadavaḍaṁ)	
read out 	 చదవండి 	(Cadavaṇḍi)	
read over 	 పైగా చదివాను 	(Paigā cadivānu)	
ready 	 సిద్ధంగా 	(Sid'dhaṅgā)	
real 	 నిజమైన 	(Nijamaina)	
realistic 	 వాస్తవికమైనది 	(Vāstavikamainadi)	
reality 	 వాస్తవికత 	(Vāstavikata)	
realize 	 గ్రహించండి 	(Grahin̄caṇḍi)	
really 	 నిజంగా 	(Nijaṅgā)	
rear 	 వెనుక 	(Venuka)	
reason 	 కారణం 	(Kāraṇaṁ)	
reasonable 	 సహేతుకమైనది 	(Sahētukamainadi)	
reasonably 	 సహేతుకంగా 	(Sahētukaṅgā)	
recall 	 రీకాల్ 	(Rīkāl)	
receipt 	 రసీదు 	(Rasīdu)	
receive 	 అందుకుంటారు 	(Andukuṇṭāru)	
recent 	 ఇటీవలి 	(Iṭīvali)	
recently 	 ఇటీవల 	(Iṭīvala)	
reception 	 రిసెప్షన్ 	(Risepṣan)	
reckon 	 లెక్క 	(Lekka)	
reckon on 	 లెక్కించు 	(Lekkin̄cu)	
recognition 	 గుర్తింపు 	(Gurtimpu)	
recognize 	 గుర్తించండి 	(Gurtin̄caṇḍi)	
recommend 	 సిఫార్సు 	(Siphārsu)	
record 	 రికార్డు 	(Rikārḍu)	
recording 	 రికార్డింగ్ 	(Rikārḍiṅg)	
recover 	 కోలుకుంటారు 	(Kōlukuṇṭāru)	
red 	 ఎరుపు 	(Erupu)	
reduce 	 తగ్గించండి 	(Taggin̄caṇḍi)	
reduction 	 తగ్గింపు 	(Taggimpu)	
refer 	 సూచించండి 	(Sūcin̄caṇḍi)	
reference 	 సూచన 	(Sūcana)	
refer to 	 సూచించండి 	(Sūcin̄caṇḍi)	
reflect 	 ప్రతిబింబిస్తాయి 	(Pratibimbistāyi)	
reform 	 సంస్కరణ 	(Sanskaraṇa)	
refrigerator 	 రిఫ్రిజిరేటర్ 	(Riphrijirēṭar)	
refusal 	 తిరస్కరణ 	(Tiraskaraṇa)	
refuse 1 	 తిరస్కరించు 1 	(Tiraskarin̄cu 1)	
regard 	 సంబంధించి 	(Sambandhin̄ci)	
regarding 	 సంబంధించి 	(Sambandhin̄ci)	
region 	 ప్రాంతం 	(Prāntaṁ)	
regional 	 ప్రాంతీయ 	(Prāntīya)	
register 	 నమోదు 	(Namōdu)	
regret 	 విచారం 	(Vicāraṁ)	
regular 	 రెగ్యులర్ 	(Regyular)	
regularly 	 క్రమం తప్పకుండా 	(Kramaṁ tappakuṇḍā)	
regulation 	 నియంత్రణ 	(Niyantraṇa)	
reject 	 తిరస్కరించండి 	(Tiraskarin̄caṇḍi)	
relate 	 సంబంధం 	(Sambandhaṁ)	
related 	 సంబంధించిన 	(Sambandhin̄cina)	
relate to 	 సంబంధించినవి 	(Sambandhin̄cinavi)	
relation 	 సంబంధం 	(Sambandhaṁ)	
relationship 	 సంబంధం 	(Sambandhaṁ)	
relative 	 బంధువు 	(Bandhuvu)	
relatively 	 సాపేక్షంగా 	(Sāpēkṣaṅgā)	
relax 	 విశ్రాంతి 	(Viśrānti)	
relaxed 	 సడలించింది 	(Saḍalin̄cindi)	
relaxing 	 సడలించడం 	(Saḍalin̄caḍaṁ)	
release 	 విడుదల 	(Viḍudala)	
relevant 	 సంబంధిత 	(Sambandhita)	
relief 	 ఉపశమనం 	(Upaśamanaṁ)	
religion 	 మతం 	(Mataṁ)	
religious 	 మతపరమైన 	(Mataparamaina)	
rely 	 ఆధారపడతారు 	(Ādhārapaḍatāru)	
rely on 	 ఆధారపడతారు 	(Ādhārapaḍatāru)	
remain 	 మిగిలి ఉన్నాయి 	(Migili unnāyi)	
remaining 	 మిగిలి ఉంది 	(Migili undi)	
remains 	 మిగిలి ఉంది 	(Migili undi)	
remark 	 వ్యాఖ్య 	(Vyākhya)	
remarkable 	 విశేషమైనది 	(Viśēṣamainadi)	
remarkably 	 విశేషమైనది 	(Viśēṣamainadi)	
remember 	 గుర్తుంచుకోవాలి 	(Gurtun̄cukōvāli)	
remind 	 గుర్తు చేయండి 	(Gurtu cēyaṇḍi)	
remind of 	 గుర్తు 	(Gurtu)	
remote 	 రిమోట్ 	(Rimōṭ)	
removal 	 తొలగింపు 	(Tolagimpu)	
remove 	 తొలగించు 	(Tolagin̄cu)	
rent 	 అద్దెకు 	(Addeku)	
rented 	 అద్దెకు తీసుకున్నారు 	(Addeku tīsukunnāru)	
repair 	 మరమ్మత్తు 	(Maram'mattu)	
repeat 	 పునరావృతం 	(Punarāvr̥taṁ)	
repeated 	 పునరావృతం 	(Punarāvr̥taṁ)	
repeatedly 	 పదే పదే 	(Padē padē)	
replace 	 భర్తీ చేయండి 	(Bhartī cēyaṇḍi)	
reply 	 ప్రత్యుత్తరం ఇవ్వండి 	(Pratyuttaraṁ ivvaṇḍi)	
report 	 నివేదిక 	(Nivēdika)	
represent 	 ప్రాతినిధ్యం వహిస్తాయి 	(Prātinidhyaṁ vahistāyi)	
representative 	 ప్రతినిధి 	(Pratinidhi)	
reproduce 	 పునరుత్పత్తి 	(Punarutpatti)	
reputation 	 కీర్తి 	(Kīrti)	
request 	 అభ్యర్థన 	(Abhyarthana)	
require 	 అవసరం 	(Avasaraṁ)	
requirement 	 అవసరం 	(Avasaraṁ)	
rescue 	 రక్షించు 	(Rakṣin̄cu)	
research 	 పరిశోధన 	(Pariśōdhana)	
reservation 	 రిజర్వేషన్ 	(Rijarvēṣan)	
reserve 	 రిజర్వ్ 	(Rijarv)	
resident 	 నివాసి 	(Nivāsi)	
resist 	 ప్రతిఘటించండి 	(Pratighaṭin̄caṇḍi)	
resistance 	 ప్రతిఘటన 	(Pratighaṭana)	
resolve 	 పరిష్కరించండి 	(Pariṣkarin̄caṇḍi)	
resort 	 రిసార్ట్ 	(Risārṭ)	
resort to 	 ఆశ్రయించండి 	(Āśrayin̄caṇḍi)	
resource 	 వనరు 	(Vanaru)	
respect 	 గౌరవం 	(Gauravaṁ)	
respond 	 స్పందించండి 	(Spandin̄caṇḍi)	
response 	 ప్రతిస్పందన 	(Pratispandana)	
responsibility 	 బాధ్యత 	(Bādhyata)	
responsible 	 బాధ్యత 	(Bādhyata)	
rest 	 విశ్రాంతి 	(Viśrānti)	
restaurant 	 రెస్టారెంట్ 	(Resṭāreṇṭ)	
restore 	 పునరుద్ధరించు 	(Punarud'dharin̄cu)	
restrict 	 పరిమితం చేయండి 	(Parimitaṁ cēyaṇḍi)	
restricted 	 పరిమితం చేయబడింది 	(Parimitaṁ cēyabaḍindi)	
restriction 	 పరిమితి 	(Parimiti)	
result 	 ఫలితం 	(Phalitaṁ)	
result in 	 ఫలితంగా 	(Phalitaṅgā)	
retain 	 నిలుపుకుంటారు 	(Nilupukuṇṭāru)	
retire 	 పదవీ విరమణ 	(Padavī viramaṇa)	
retired 	 పదవీ విరమణ చేశారు 	(Padavī viramaṇa cēśāru)	
retirement 	 పదవీ విరమణ 	(Padavī viramaṇa)	
return 	 తిరిగి 	(Tirigi)	
reveal 	 బహిర్గతం 	(Bahirgataṁ)	
reverse 	 రివర్స్ 	(Rivars)	
review 	 సమీక్షించండి 	(Samīkṣin̄caṇḍi)	
revise 	 సవరించు 	(Savarin̄cu)	
revision 	 పునర్విమర్శ 	(Punarvimarśa)	
revolution 	 విప్లవం 	(Viplavaṁ)	
reward 	 బహుమతి 	(Bahumati)	
rhythm 	 లయ 	(Laya)	
rice 	 బియ్యం 	(Biyyaṁ)	
rich 	 ధనవంతుడు 	(Dhanavantuḍu)	
rid 	 వదిలించుకోండి 	(Vadilin̄cukōṇḍi)	
ride 	 రైడ్ 	(Raiḍ)	
rider 	 రైడర్ 	(Raiḍar)	
ridiculous 	 హాస్యాస్పదమైనది 	(Hāsyāspadamainadi)	
riding 	 స్వారీ 	(Svārī)	
right 	 కుడి 	(Kuḍi)	
rightly 	 సరిగ్గా 	(Sariggā)	
ring 1 	 రింగ్ 1 	(Riṅg 1)	
ring 2 	 రింగ్ 2 	(Riṅg 2)	
ring back 	 తిరిగి రింగ్ 	(Tirigi riṅg)	
rise 	 పెరుగుతాయి 	(Perugutāyi)	
risk 	 ప్రమాదం 	(Pramādaṁ)	
rival 	 ప్రత్యర్థి 	(Pratyarthi)	
river 	 నది 	(Nadi)	
road 	 రహదారి 	(Rahadāri)	
rob 	 దోచుకోండి 	(Dōcukōṇḍi)	
rock 	 శిల 	(Śila)	
role 	 పాత్ర 	(Pātra)	
roll 	 రోల్ 	(Rōl)	
romantic 	 రొమాంటిక్ 	(Romāṇṭik)	
roof 	 పైకప్పు 	(Paikappu)	
room 	 గది 	(Gadi)	
root 	 రూట్ 	(Rūṭ)	
rope 	 తాడు 	(Tāḍu)	
rough 	 కఠినమైన 	(Kaṭhinamaina)	
roughly 	 సుమారుగా 	(Sumārugā)	
round 	 గుండ్రంగా 	(Guṇḍraṅgā)	
rounded 	 గుండ్రంగా 	(Guṇḍraṅgā)	
route 	 మార్గం 	(Mārgaṁ)	
routine 	 రొటీన్ 	(Roṭīn)	
row 1 	 వరుస 1 	(Varusa 1)	
royal 	 రాజ సంబంధమైన 	(Rāja sambandhamaina)	
rub 	 రుద్దు 	(Ruddu)	
rubber 	 రబ్బరు 	(Rabbaru)	
rubbish 	 చెత్త 	(Cetta)	
rude 	 మొరటుగా 	(Moraṭugā)	
rudely 	 మొరటుగా 	(Moraṭugā)	
ruin 	 నాశనము 	(Nāśanamu)	
ruined 	 నాశనమైంది 	(Nāśanamaindi)	
rule 	 పాలన 	(Pālana)	
rule out 	 పాలించు 	(Pālin̄cu)	
ruler 	 పాలకుడు 	(Pālakuḍu)	
rumour 	 పుకారు 	(Pukāru)	
run 	 పరుగు 	(Parugu)	
run after 	 తర్వాత పరుగు 	(Tarvāta parugu)	
run away 	 పారిపోతారు 	(Pāripōtāru)	
runner 	 రన్నర్ 	(Rannar)	
running 	 నడుస్తోంది 	(Naḍustōndi)	
run out 	 అయిపోయింది 	(Ayipōyindi)	
run over 	 పరుగు 	(Parugu)	
run through 	 ద్వారా అమలు 	(Dvārā amalu)	
rural 	 గ్రామీణ 	(Grāmīṇa)	
rush 	 హడావిడి 	(Haḍāviḍi)	
sack 	 సాక్ 	(Sāk)	
sad 	 విచారంగా ఉంది 	(Vicāraṅgā undi)	
sadly 	 పాపం 	(Pāpaṁ)	
sadness 	 విచారం 	(Vicāraṁ)	
safe 	 సురక్షితం 	(Surakṣitaṁ)	
safely 	 సురక్షితంగా 	(Surakṣitaṅgā)	
safety 	 భద్రత 	(Bhadrata)	
sail 	 తెరచాప 	(Teracāpa)	
sailing 	 నౌకాయానం 	(Naukāyānaṁ)	
sailor 	 నావికుడు 	(Nāvikuḍu)	
salad 	 సలాడ్ 	(Salāḍ)	
salary 	 జీతం 	(Jītaṁ)	
sale 	 అమ్మకం 	(Am'makaṁ)	
salt 	 ఉప్పు 	(Uppu)	
salty 	 ఉప్పగా ఉంటుంది 	(Uppagā uṇṭundi)	
same 	 అదే 	(Adē)	
sample 	 నమూనా 	(Namūnā)	
sand 	 ఇసుక 	(Isuka)	
satisfaction 	 సంతృప్తి 	(Santr̥pti)	
satisfied 	 సంతృప్తి చెందారు 	(Santr̥pti cendāru)	
satisfy 	 సంతృప్తి చెందుతాయి 	(Santr̥pti cendutāyi)	
satisfying 	 సంతృప్తినిస్తుంది 	(Santr̥ptinistundi)	
Saturday 	 శనివారం 	(Śanivāraṁ)	
sauce 	 సాస్ 	(Sās)	
save 	 సేవ్ 	(Sēv)	
saving 	 పొదుపు 	(Podupu)	
say 	 అంటున్నారు 	(Aṇṭunnāru)	
scale 	 స్థాయి 	(Sthāyi)	
scare 	 భయపెట్టు 	(Bhayapeṭṭu)	
scared 	 భయపడ్డాను 	(Bhayapaḍḍānu)	
scare off 	 భయపెట్టు 	(Bhayapeṭṭu)	
scene 	 దృశ్యం 	(Dr̥śyaṁ)	
schedule 	 షెడ్యూల్ 	(Ṣeḍyūl)	
scheme 	 పథకం 	(Pathakaṁ)	
school 	 పాఠశాల 	(Pāṭhaśāla)	
science 	 సైన్స్ 	(Sains)	
scientific 	 శాస్త్రీయమైనది 	(Śāstrīyamainadi)	
scientist 	 శాస్త్రవేత్త 	(Śāstravētta)	
scissors 	 కత్తెర 	(Kattera)	
score 	 స్కోర్ 	(Skōr)	
scratch 	 స్క్రాచ్ 	(Skrāc)	
scream 	 అరుపు 	(Arupu)	
screen 	 తెర 	(Tera)	
screw 	 స్క్రూ 	(Skrū)	
sea 	 సముద్రం 	(Samudraṁ)	
seal 	 ముద్ర 	(Mudra)	
seal off 	 సీల్ ఆఫ్ 	(Sīl āph)	
search 	 శోధన 	(Śōdhana)	
season 	 సీజన్ 	(Sījan)	
seat 	 సీటు 	(Sīṭu)	
second 1 	 రెండవ 1 	(Reṇḍava 1)	
secondary 	 ద్వితీయ 	(Dvitīya)	
secret 	 రహస్య 	(Rahasya)	
secretary 	 కార్యదర్శి 	(Kāryadarśi)	
secretly 	 రహస్యంగా 	(Rahasyaṅgā)	
section 	 విభాగం 	(Vibhāgaṁ)	
sector 	 రంగం 	(Raṅgaṁ)	
secure 	 సురక్షితమైన 	(Surakṣitamaina)	
security 	 భద్రత 	(Bhadrata)	
see 	 చూడండి 	(Cūḍaṇḍi)	
see about 	 గురించి చూడండి 	(Gurin̄ci cūḍaṇḍi)	
seed 	 విత్తనం 	(Vittanaṁ)	
seek 	 కోరుకుంటారు 	(Kōrukuṇṭāru)	
seem 	 అనిపించవచ్చు 	(Anipin̄cavaccu)	
see to 	 చూడండి 	(Cūḍaṇḍi)	
select 	 ఎంచుకోండి 	(En̄cukōṇḍi)	
selection 	 ఎంపిక 	(Empika)	
self 	 స్వీయ 	(Svīya)	
self- 	 స్వీయ- 	(Svīya-)	
sell 	 అమ్ముతారు 	(Am'mutāru)	
sell off 	 అమ్మేస్తారు 	(Am'mēstāru)	
sell out 	 అమ్ముతాడు 	(Am'mutāḍu)	
senate 	 సెనేట్ 	(Senēṭ)	
senator 	 సెనేటర్ 	(Senēṭar)	
send 	 పంపండి 	(Pampaṇḍi)	
send for 	 కోసం పంపండి 	(Kōsaṁ pampaṇḍi)	
send off 	 పంపించు 	(Pampin̄cu)	
senior 	 సీనియర్ 	(Sīniyar)	
sense 	 భావం 	(Bhāvaṁ)	
sensible 	 తెలివిగల 	(Telivigala)	
sensitive 	 సున్నితమైన 	(Sunnitamaina)	
sentence 	 వాక్యం 	(Vākyaṁ)	
separate 	 వేరు 	(Vēru)	
separated 	 వేరు 	(Vēru)	
separately 	 విడిగా 	(Viḍigā)	
separation 	 వేరు 	(Vēru)	
September 	 సెప్టెంబర్ 	(Sepṭembar)	
series 	 సిరీస్ 	(Sirīs)	
serious 	 తీవ్రమైన 	(Tīvramaina)	
seriously 	 తీవ్రంగా 	(Tīvraṅgā)	
servant 	 సేవకుడు 	(Sēvakuḍu)	
serve 	 సర్వ్ 	(Sarv)	
service 	 సేవ 	(Sēva)	
session 	 సెషన్ 	(Seṣan)	
set 	 సెట్ 	(Seṭ)	
set off 	 బయలుదేరాడు 	(Bayaludērāḍu)	
set out 	 బయలుదేరాడు 	(Bayaludērāḍu)	
settle 	 తేల్చుకోండి 	(Tēlcukōṇḍi)	
settle down 	 స్థిరపడతారు 	(Sthirapaḍatāru)	
set up 	 ఏర్పాటు 	(Ērpāṭu)	
seven 	 ఏడు 	(Ēḍu)	
seventeen 	 పదిహేడు 	(Padihēḍu)	
seventh 	 ఏడవ 	(Ēḍava)	
seventieth 	 డెబ్బైవది 	(Ḍebbaivadi)	
seventy 	 డెబ్బై 	(Ḍebbai)	
several 	 అనేక 	(Anēka)	
severe 	 తీవ్రమైన 	(Tīvramaina)	
severely 	 తీవ్రంగా 	(Tīvraṅgā)	
sew 	 కుట్టుమిషన్ 	(Kuṭṭumiṣan)	
sewing 	 కుట్టుపని 	(Kuṭṭupani)	
sex 	 సెక్స్ 	(Seks)	
sexual 	 లైంగిక 	(Laiṅgika)	
sexually 	 లైంగికంగా 	(Laiṅgikaṅgā)	
shade 	 నీడ 	(Nīḍa)	
shadow 	 నీడ 	(Nīḍa)	
shake 	 వణుకు 	(Vaṇuku)	
shall 	 ఉంటుంది 	(Uṇṭundi)	
shallow 	 నిస్సారమైన 	(Nis'sāramaina)	
shame 	 అవమానం 	(Avamānaṁ)	
shape 	 ఆకారం 	(Ākāraṁ)	
shaped 	 ఆకారంలో 	(Ākāranlō)	
share 	 వాటా 	(Vāṭā)	
sharp 	 పదునైన 	(Padunaina)	
sharply 	 పదునుగా 	(Padunugā)	
shave 	 గొరుగుట 	(Goruguṭa)	
she 	 ఆమె 	(Āme)	
sheep 	 గొర్రెలు 	(Gorrelu)	
sheet 	 షీట్ 	(Ṣīṭ)	
shelf 	 షెల్ఫ్ 	(Ṣelph)	
shell 	 షెల్ 	(Ṣel)	
shelter 	 ఆశ్రయం 	(Āśrayaṁ)	
shift 	 షిఫ్ట్ 	(Ṣiphṭ)	
shine 	 ప్రకాశిస్తాయి 	(Prakāśistāyi)	
shiny 	 మెరిసే 	(Merisē)	
ship 	 ఓడ 	(Ōḍa)	
shirt 	 చొక్కా 	(Cokkā)	
shock 	 షాక్ 	(Ṣāk)	
shocked 	 ఆశ్చర్యపోయాడు 	(Āścaryapōyāḍu)	
shocking 	 షాకింగ్ 	(Ṣākiṅg)	
shoe 	 షూ 	(Ṣū)	
shoot 	 షూట్ 	(Ṣūṭ)	
shoot down 	 కాల్చివేయండి 	(Kālcivēyaṇḍi)	
shooting 	 షూటింగ్ 	(Ṣūṭiṅg)	
shop 	 దుకాణం 	(Dukāṇaṁ)	
shopping 	 షాపింగ్ 	(Ṣāpiṅg)	
short 	 చిన్నది 	(Cinnadi)	
shortly 	 త్వరలో 	(Tvaralō)	
shot 	 కాల్చారు 	(Kālcāru)	
should 	 ఉండాలి 	(Uṇḍāli)	
shoulder 	 భుజం 	(Bhujaṁ)	
shout 	 అరవండి 	(Aravaṇḍi)	
show 	 చూపించు 	(Cūpin̄cu)	
shower 	 షవర్ 	(Ṣavar)	
show off 	 చూపించు 	(Cūpin̄cu)	
show round 	 రౌండ్ చూపించు 	(Rauṇḍ cūpin̄cu)	
show up 	 చూపించు 	(Cūpin̄cu)	
shut 	 మూసి 	(Mūsi)	
shut down 	 మూసివేసింది 	(Mūsivēsindi)	
shut in 	 మూసివేసింది 	(Mūsivēsindi)	
shut out 	 మూసివేసింది 	(Mūsivēsindi)	
shut up 	 నోరుమూసుకో 	(Nōrumūsukō)	
shy 	 పిరికి 	(Piriki)	
sick 	 జబ్బుపడిన 	(Jabbupaḍina)	
side 	 వైపు 	(Vaipu)	
sideways 	 పక్కకి 	(Pakkaki)	
sight 	 దృష్టి 	(Dr̥ṣṭi)	
sign 	 సంకేతం 	(Saṅkētaṁ)	
signal 	 సిగ్నల్ 	(Signal)	
signature 	 సంతకం 	(Santakaṁ)	
significant 	 ముఖ్యమైనది 	(Mukhyamainadi)	
significantly 	 గణనీయంగా 	(Gaṇanīyaṅgā)	
silence 	 నిశ్శబ్దం 	(Niśśabdaṁ)	
silent 	 మౌనంగా 	(Maunaṅgā)	
silk 	 పట్టు 	(Paṭṭu)	
silly 	 వెర్రి 	(Verri)	
silver 	 వెండి 	(Veṇḍi)	
similar 	 ఇలాంటి 	(Ilāṇṭi)	
similarly 	 అదేవిధంగా 	(Adēvidhaṅgā)	
simple 	 సాధారణ 	(Sādhāraṇa)	
simply 	 కేవలం 	(Kēvalaṁ)	
since 	 నుండి 	(Nuṇḍi)	
sincere 	 నిష్కపటమైన 	(Niṣkapaṭamaina)	
sincerely 	 హృదయపూర్వకంగా 	(Hr̥dayapūrvakaṅgā)	
sing 	 పాడతారు 	(Pāḍatāru)	
singer 	 గాయకుడు 	(Gāyakuḍu)	
singing 	 పాడుతున్నారు 	(Pāḍutunnāru)	
single 	 సింగిల్ 	(Siṅgil)	
sink 	 మునిగిపోతుంది 	(Munigipōtundi)	
sir 	 సార్ 	(Sār)	
sister 	 సోదరి 	(Sōdari)	
sit 	 కూర్చోండి 	(Kūrcōṇḍi)	
sit down 	 కూర్చోండి 	(Kūrcōṇḍi)	
site 	 సైట్ 	(Saiṭ)	
situation 	 పరిస్థితి 	(Paristhiti)	
six 	 ఆరు 	(Āru)	
sixteen 	 పదహారు 	(Padahāru)	
sixth 	 ఆరవది 	(Āravadi)	
sixtieth 	 అరవయ్యవది 	(Aravayyavadi)	
sixty 	 అరవై 	(Aravai)	
size 	 పరిమాణం 	(Parimāṇaṁ)	
skilful 	 నైపుణ్యం కలవాడు 	(Naipuṇyaṁ kalavāḍu)	
skilfully 	 నేర్పుగా 	(Nērpugā)	
skill 	 నైపుణ్యం 	(Naipuṇyaṁ)	
skilled 	 నైపుణ్యం కలవాడు 	(Naipuṇyaṁ kalavāḍu)	
skin 	 చర్మం 	(Carmaṁ)	
skirt 	 లంగా 	(Laṅgā)	
sky 	 ఆకాశం 	(Ākāśaṁ)	
sleep 	 నిద్ర 	(Nidra)	
sleeve 	 స్లీవ్ 	(Slīv)	
slice 	 ముక్క 	(Mukka)	
slide 	 స్లయిడ్ 	(Slayiḍ)	
slight 	 కొంచెం 	(Kon̄ceṁ)	
slightly 	 కొద్దిగా 	(Koddigā)	
slip 	 స్లిప్ 	(Slip)	
slope 	 వాలు 	(Vālu)	
slow 	 నెమ్మదిగా 	(Nem'madigā)	
slowly 	 నెమ్మదిగా 	(Nem'madigā)	
small 	 చిన్నది 	(Cinnadi)	
smart 	 తెలివైన 	(Telivaina)	
smash 	 పగులగొట్టు 	(Pagulagoṭṭu)	
smell 	 వాసన 	(Vāsana)	
smile 	 చిరునవ్వు 	(Cirunavvu)	
smoke 	 పొగ 	(Poga)	
smoking 	 ధూమపానం 	(Dhūmapānaṁ)	
smooth 	 మృదువైన 	(Mr̥duvaina)	
smoothly 	 సజావుగా 	(Sajāvugā)	
snake 	 పాము 	(Pāmu)	
snow 	 మంచు 	(Man̄cu)	
so 	 కాబట్టి 	(Kābaṭṭi)	
soap 	 సబ్బు 	(Sabbu)	
social 	 సామాజిక 	(Sāmājika)	
socially 	 సామాజికంగా 	(Sāmājikaṅgā)	
society 	 సమాజం 	(Samājaṁ)	
sock 	 గుంట 	(Guṇṭa)	
soft 	 మృదువైన 	(Mr̥duvaina)	
softly 	 మెత్తగా 	(Mettagā)	
software 	 సాఫ్ట్వేర్ 	(Sāphṭvēr)	
soil 	 నేల 	(Nēla)	
soldier 	 సైనికుడు 	(Sainikuḍu)	
solid 	 ఘనమైన 	(Ghanamaina)	
solution 	 పరిష్కారం 	(Pariṣkāraṁ)	
solve 	 పరిష్కరించండి 	(Pariṣkarin̄caṇḍi)	
some 	 కొన్ని 	(Konni)	
somebody 	 ఎవరైనా 	(Evarainā)	
somehow 	 ఎలాగోలా 	(Elāgōlā)	
someone 	 ఎవరైనా 	(Evarainā)	
something 	 ఏదో 	(Ēdō)	
sometimes 	 కొన్నిసార్లు 	(Konnisārlu)	
somewhat 	 కొంతవరకు 	(Kontavaraku)	
somewhere 	 ఎక్కడో 	(Ekkaḍō)	
son 	 కొడుకు 	(Koḍuku)	
song 	 పాట 	(Pāṭa)	
soon 	 త్వరలో 	(Tvaralō)	
sore 	 పుండు 	(Puṇḍu)	
sorry 	 క్షమించండి 	(Kṣamin̄caṇḍi)	
sort 	 క్రమబద్ధీకరించు 	(Kramabad'dhīkarin̄cu)	
sort out 	 క్రమబద్ధీకరించు 	(Kramabad'dhīkarin̄cu)	
soul 	 ఆత్మ 	(Ātma)	
sound 	 ధ్వని 	(Dhvani)	
soup 	 చారు 	(Cāru)	
sour 	 పులుపు 	(Pulupu)	
source 	 మూలం 	(Mūlaṁ)	
south 	 దక్షిణ 	(Dakṣiṇa)	
southern 	 దక్షిణాది 	(Dakṣiṇādi)	
space 	 స్థలం 	(Sthalaṁ)	
spare 	 విడిగా 	(Viḍigā)	
speak 	 మాట్లాడతారు 	(Māṭlāḍatāru)	
speaker 	 స్పీకర్ 	(Spīkar)	
speak out 	 మాట్లాడు 	(Māṭlāḍu)	
speak up 	 మాట్లాడు 	(Māṭlāḍu)	
special 	 ప్రత్యేక 	(Pratyēka)	
specialist 	 నిపుణుడు 	(Nipuṇuḍu)	
specially 	 ప్రత్యేకంగా 	(Pratyēkaṅgā)	
specific 	 నిర్దిష్టమైన 	(Nirdiṣṭamaina)	
specifically 	 ప్రత్యేకంగా 	(Pratyēkaṅgā)	
speech 	 ప్రసంగం 	(Prasaṅgaṁ)	
speed 	 వేగం 	(Vēgaṁ)	
speed up 	 వేగవంతం 	(Vēgavantaṁ)	
spell 	 స్పెల్ 	(Spel)	
spelling 	 స్పెల్లింగ్ 	(Spelliṅg)	
spend 	 ఖర్చు చేస్తారు 	(Kharcu cēstāru)	
spice 	 మసాలా 	(Masālā)	
spicy 	 కారంగా 	(Kāraṅgā)	
spider 	 సాలీడు 	(Sālīḍu)	
spin 	 స్పిన్ 	(Spin)	
spirit 	 ఆత్మ 	(Ātma)	
spiritual 	 ఆధ్యాత్మికం 	(Ādhyātmikaṁ)	
spite 	 ఉన్నప్పటికీ 	(Unnappaṭikī)	
split 	 విడిపోయింది 	(Viḍipōyindi)	
split up 	 విడిపోయింది 	(Viḍipōyindi)	
spoil 	 పాడు 	(Pāḍu)	
spoken 	 మాట్లాడాడు 	(Māṭlāḍāḍu)	
spoon 	 చెంచా 	(Cen̄cā)	
sport 	 క్రీడ 	(Krīḍa)	
spot 	 స్పాట్ 	(Spāṭ)	
spray 	 స్ప్రే 	(Sprē)	
spread 	 వ్యాప్తి 	(Vyāpti)	
spread out 	 విస్తరించింది 	(Vistarin̄cindi)	
spring 	 వసంత 	(Vasanta)	
square 	 చతురస్రం 	(Caturasraṁ)	
squeeze 	 పిండి వేయు 	(Piṇḍi vēyu)	
stable 	 స్థిరమైన 	(Sthiramaina)	
staff 	 సిబ్బంది 	(Sibbandi)	
stage 	 వేదిక 	(Vēdika)	
stair 	 మెట్లు 	(Meṭlu)	
stamp 	 స్టాంపు 	(Sṭāmpu)	
stand 	 నిలబడండి 	(Nilabaḍaṇḍi)	
standard 	 ప్రమాణం 	(Pramāṇaṁ)	
stand back 	 తిరిగి నిలబడు 	(Tirigi nilabaḍu)	
stand by 	 నిలబడు 	(Nilabaḍu)	
stand for 	 నిలబడు 	(Nilabaḍu)	
stand out 	 నిలబడి 	(Nilabaḍi)	
stand up 	 లేచి నిలబడండి 	(Lēci nilabaḍaṇḍi)	
stand up for 	 నిలబడు 	(Nilabaḍu)	
star 	 నక్షత్రం 	(Nakṣatraṁ)	
stare 	 తదేకంగా చూడు 	(Tadēkaṅgā cūḍu)	
start 	 ప్రారంభించండి 	(Prārambhin̄caṇḍi)	
start off 	 ప్రారంభించండి 	(Prārambhin̄caṇḍi)	
start out 	 ప్రారంభించండి 	(Prārambhin̄caṇḍi)	
start up 	 ప్రారంభించండి 	(Prārambhin̄caṇḍi)	
state 	 రాష్ట్రం 	(Rāṣṭraṁ)	
statement 	 ప్రకటన 	(Prakaṭana)	
station 	 స్టేషన్ 	(Sṭēṣan)	
statue 	 విగ్రహం 	(Vigrahaṁ)	
status 	 హోదా 	(Hōdā)	
stay 	 ఉండు 	(Uṇḍu)	
stay away 	 దూరంగా ఉండండి 	(Dūraṅgā uṇḍaṇḍi)	
stay out of 	 బయట ఉండు 	(Bayaṭa uṇḍu)	
steadily 	 స్థిరంగా 	(Sthiraṅgā)	
steady 	 స్థిరమైన 	(Sthiramaina)	
steal 	 దొంగతనం చేస్తారు 	(Doṅgatanaṁ cēstāru)	
steam 	 ఆవిరి 	(Āviri)	
steel 	 ఉక్కు 	(Ukku)	
steep 	 నిటారుగా 	(Niṭārugā)	
steeply 	 నిటారుగా 	(Niṭārugā)	
steer 	 నడిపించు 	(Naḍipin̄cu)	
step 	 అడుగు 	(Aḍugu)	
stick 	 కర్ర 	(Karra)	
stick out 	 బయటకు కర్ర 	(Bayaṭaku karra)	
stick to 	 కర్ర 	(Karra)	
stick up 	 కర్ర 	(Karra)	
sticky 	 అంటుకునే 	(Aṇṭukunē)	
stiff 	 గట్టి 	(Gaṭṭi)	
stiffly 	 ఠీవిగా 	(Ṭhīvigā)	
still 	 ఇప్పటికీ 	(Ippaṭikī)	
sting 	 స్టింగ్ 	(Sṭiṅg)	
stir 	 కదిలించు 	(Kadilin̄cu)	
stock 	 స్టాక్ 	(Sṭāk)	
stomach 	 కడుపు 	(Kaḍupu)	
stone 	 రాయి 	(Rāyi)	
stop 	 ఆపండి 	(Āpaṇḍi)	
store 	 స్టోర్ 	(Sṭōr)	
storm 	 తుఫాను 	(Tuphānu)	
story 	 కథ 	(Katha)	
stove 	 పొయ్యి 	(Poyyi)	
straight 	 నేరుగా 	(Nērugā)	
strain 	 ఒత్తిడి 	(Ottiḍi)	
strange 	 వింత 	(Vinta)	
strangely 	 వింతగా 	(Vintagā)	
stranger 	 అపరిచితుడు 	(Aparicituḍu)	
strategy 	 వ్యూహం 	(Vyūhaṁ)	
stream 	 ప్రవాహం 	(Pravāhaṁ)	
street 	 వీధి 	(Vīdhi)	
strength 	 బలం 	(Balaṁ)	
stress 	 ఒత్తిడి 	(Ottiḍi)	
stressed 	 నొక్కిచెప్పారు 	(Nokkiceppāru)	
stretch 	 సాగదీయడం 	(Sāgadīyaḍaṁ)	
strict 	 కఠినమైన 	(Kaṭhinamaina)	
strictly 	 కఠినంగా 	(Kaṭhinaṅgā)	
strike 	 సమ్మె 	(Sam'me)	
striking 	 కొట్టడం 	(Koṭṭaḍaṁ)	
string 	 స్ట్రింగ్ 	(Sṭriṅg)	
strip 	 స్ట్రిప్ 	(Sṭrip)	
stripe 	 గీత 	(Gīta)	
striped 	 చారల 	(Cārala)	
stroke 	 స్ట్రోక్ 	(Sṭrōk)	
strong 	 బలమైన 	(Balamaina)	
strongly 	 గట్టిగా 	(Gaṭṭigā)	
structure 	 నిర్మాణం 	(Nirmāṇaṁ)	
struggle 	 పోరాటం 	(Pōrāṭaṁ)	
student 	 విద్యార్థి 	(Vidyārthi)	
studio 	 స్టూడియో 	(Sṭūḍiyō)	
study 	 చదువు 	(Caduvu)	
stuff 	 అంశాలు 	(Anśālu)	
stupid 	 తెలివితక్కువ 	(Telivitakkuva)	
style 	 శైలి 	(Śaili)	
subject 	 విషయం 	(Viṣayaṁ)	
substance 	 పదార్ధం 	(Padārdhaṁ)	
substantial 	 గణనీయమైన 	(Gaṇanīyamaina)	
substantially 	 గణనీయంగా 	(Gaṇanīyaṅgā)	
substitute 	 ప్రత్యామ్నాయం 	(Pratyāmnāyaṁ)	
succeed 	 విజయం సాధిస్తారు 	(Vijayaṁ sādhistāru)	
success 	 విజయం 	(Vijayaṁ)	
successful 	 విజయవంతమైంది 	(Vijayavantamaindi)	
successfully 	 విజయవంతంగా 	(Vijayavantaṅgā)	
such 	 అటువంటి 	(Aṭuvaṇṭi)	
suck 	 పీలుస్తుంది 	(Pīlustundi)	
sudden 	 ఆకస్మికంగా 	(Ākasmikaṅgā)	
suddenly 	 అకస్మాత్తుగా 	(Akasmāttugā)	
suffer 	 బాధపడతారు 	(Bādhapaḍatāru)	
suffering 	 బాధ 	(Bādha)	
sufficient 	 తగినంత 	(Taginanta)	
sufficiently 	 తగినంతగా 	(Taginantagā)	
sugar 	 చక్కెర 	(Cakkera)	
suggest 	 సూచించండి 	(Sūcin̄caṇḍi)	
suggestion 	 సూచన 	(Sūcana)	
suit 	 దావా 	(Dāvā)	
suitable 	 తగినది 	(Taginadi)	
suitcase 	 సూట్కేస్ 	(Sūṭkēs)	
suited 	 సరిపోయింది 	(Saripōyindi)	
sum 	 మొత్తం 	(Mottaṁ)	
summary 	 సారాంశం 	(Sārānśaṁ)	
summer 	 వేసవి 	(Vēsavi)	
sum up 	 మొత్తం 	(Mottaṁ)	
sun 	 సూర్యుడు 	(Sūryuḍu)	
Sunday 	 ఆదివారం 	(Ādivāraṁ)	
superior 	 ఉన్నతమైన 	(Unnatamaina)	
supermarket 	 సూపర్ మార్కెట్ 	(Sūpar mārkeṭ)	
supply 	 సరఫరా 	(Sarapharā)	
support 	 మద్దతు 	(Maddatu)	
supporter 	 మద్దతుదారు 	(Maddatudāru)	
suppose 	 అనుకుందాం 	(Anukundāṁ)	
sure 	 ఖచ్చితంగా 	(Khaccitaṅgā)	
surely 	 తప్పకుండా 	(Tappakuṇḍā)	
surface 	 ఉపరితలం 	(Uparitalaṁ)	
surname 	 ఇంటిపేరు 	(Iṇṭipēru)	
surprise 	 ఆశ్చర్యం 	(Āścaryaṁ)	
surprised 	 ఆశ్చర్యపోయాడు 	(Āścaryapōyāḍu)	
surprising 	 ఆశ్చర్యకరం 	(Āścaryakaraṁ)	
surprisingly 	 ఆశ్చర్యకరంగా 	(Āścaryakaraṅgā)	
surround 	 చుట్టుముట్టండి 	(Cuṭṭumuṭṭaṇḍi)	
surrounding 	 పరిసర 	(Parisara)	
surroundings 	 పరిసరాలు 	(Parisarālu)	
survey 	 సర్వే 	(Sarvē)	
survive 	 బ్రతుకుతాయి 	(Bratukutāyi)	
suspect 	 అనుమానిస్తున్నారు 	(Anumānistunnāru)	
suspicion 	 అనుమానం 	(Anumānaṁ)	
suspicious 	 అనుమానాస్పదమైన 	(Anumānāspadamaina)	
swallow 	 మ్రింగు 	(Mriṅgu)	
swear 	 ప్రమాణం 	(Pramāṇaṁ)	
swearing 	 తిట్లు 	(Tiṭlu)	
sweat 	 చెమట 	(Cemaṭa)	
sweater 	 స్వెటర్ 	(Sveṭar)	
sweep 	 స్వీప్ 	(Svīp)	
sweet 	 తీపి 	(Tīpi)	
swell 	 ఉబ్బు 	(Ubbu)	
swelling 	 వాపు 	(Vāpu)	
swim 	 ఈత కొట్టండి 	(Īta koṭṭaṇḍi)	
swimming 	 ఈత కొట్టడం 	(Īta koṭṭaḍaṁ)	
swimming pool 	 ఈత కొలను 	(Īta kolanu)	
swing 	 స్వింగ్ 	(Sviṅg)	
switch 	 మారండి 	(Māraṇḍi)	
switch off 	 స్విచ్ ఆఫ్ 	(Svic āph)	
swollen 	 ఉబ్బిన 	(Ubbina)	
symbol 	 చిహ్నం 	(Cihnaṁ)	
sympathetic 	 సానుభూతిపరుడు 	(Sānubhūtiparuḍu)	
sympathy 	 సానుభూతి 	(Sānubhūti)	
system 	 వ్యవస్థ 	(Vyavastha)	
table 	 పట్టిక 	(Paṭṭika)	
tablet 	 టాబ్లెట్ 	(Ṭābleṭ)	
tackle 	 అధిగమించేందుకు 	(Adhigamin̄cēnduku)	
tail 	 తోక 	(Tōka)	
take 	 పడుతుంది 	(Paḍutundi)	
take away 	 తీసుకెళ్ళండి 	(Tīsukeḷḷaṇḍi)	
take back 	 వెనక్కి తీసుకో 	(Venakki tīsukō)	
take down 	 దించు 	(Din̄cu)	
take in 	 లోపలికి తీసుకోండి 	(Lōpaliki tīsukōṇḍi)	
take off 	 బయలుదేరు 	(Bayaludēru)	
take on 	 తీసుకుంటారు 	(Tīsukuṇṭāru)	
take over 	 స్వాధీనం చేసుకుంటాయి 	(Svādhīnaṁ cēsukuṇṭāyi)	
take up 	 చేపట్టండి 	(Cēpaṭṭaṇḍi)	
talk 	 మాట్లాడండి 	(Māṭlāḍaṇḍi)	
tall 	 పొడవు 	(Poḍavu)	
tank 	 ట్యాంక్ 	(Ṭyāṅk)	
tap 	 నొక్కండి 	(Nokkaṇḍi)	
tape 	 టేప్ 	(Ṭēp)	
target 	 లక్ష్యం 	(Lakṣyaṁ)	
task 	 పని 	(Pani)	
taste 	 రుచి 	(Ruci)	
tax 	 పన్ను 	(Pannu)	
taxi 	 టాక్సీ 	(Ṭāksī)	
tea 	 టీ 	(Ṭī)	
teach 	 బోధిస్తారు 	(Bōdhistāru)	
teacher 	 గురువు 	(Guruvu)	
teaching 	 బోధన 	(Bōdhana)	
team 	 జట్టు 	(Jaṭṭu)	
tear 1 	 కన్నీరు 1 	(Kannīru 1)	
tear 2 	 కన్నీరు 2 	(Kannīru 2)	
tear up 	 కూల్చివేసి 	(Kūlcivēsi)	
technical 	 సాంకేతిక 	(Sāṅkētika)	
technique 	 సాంకేతికత 	(Sāṅkētikata)	
technology 	 సాంకేతికత 	(Sāṅkētikata)	
telephone 	 టెలిఫోన్ 	(Ṭeliphōn)	
television 	 టెలివిజన్ 	(Ṭelivijan)	
tell 	 చెప్పు 	(Ceppu)	
tell off 	 చెప్పు 	(Ceppu)	
temperature 	 ఉష్ణోగ్రత 	(Uṣṇōgrata)	
temporarily 	 తాత్కాలికంగా 	(Tātkālikaṅgā)	
temporary 	 తాత్కాలిక 	(Tātkālika)	
ten 	 పది 	(Padi)	
tend 	 మొగ్గు 	(Moggu)	
tendency 	 ధోరణి 	(Dhōraṇi)	
tension 	 ఉద్రిక్తత 	(Udriktata)	
tent 	 డేరా 	(Ḍērā)	
tenth 	 పదవ 	(Padava)	
term 	 పదం 	(Padaṁ)	
terrible 	 భయంకరమైన 	(Bhayaṅkaramaina)	
terribly 	 భయంకరంగా 	(Bhayaṅkaraṅgā)	
test 	 పరీక్ష 	(Parīkṣa)	
text 	 వచనం 	(Vacanaṁ)	
than 	 కంటే 	(Kaṇṭē)	
thank 	 ధన్యవాదాలు 	(Dhan'yavādālu)	
thanks 	 ధన్యవాదాలు 	(Dhan'yavādālu)	
thank you 	 ధన్యవాదాలు 	(Dhan'yavādālu)	
that 	 అని 	(Ani)	
the 	 ది 	(Di)	
theatre 	 థియేటర్ 	(Thiyēṭar)	
their 	 వారి 	(Vāri)	
theirs 	 వారిది 	(Vāridi)	
them 	 వాటిని 	(Vāṭini)	
theme 	 థీమ్ 	(Thīm)	
themselves 	 తమను తాము 	(Tamanu tāmu)	
then 	 అప్పుడు 	(Appuḍu)	
theory 	 సిద్ధాంతం 	(Sid'dhāntaṁ)	
there 	 అక్కడ 	(Akkaḍa)	
therefore 	 అందువలన 	(Anduvalana)	
they 	 వారు 	(Vāru)	
thick 	 మందపాటి 	(Mandapāṭi)	
thickly 	 మందంగా 	(Mandaṅgā)	
thickness 	 మందం 	(Mandaṁ)	
thief 	 దొంగ 	(Doṅga)	
thin 	 సన్నగా 	(Sannagā)	
thing 	 విషయం 	(Viṣayaṁ)	
think 	 అనుకుంటాను 	(Anukuṇṭānu)	
think about 	 గురించి ఆలోచించండి 	(Gurin̄ci ālōcin̄caṇḍi)	
thinking 	 ఆలోచిస్తున్నాను 	(Ālōcistunnānu)	
think of 	 అనుకుంటాను 	(Anukuṇṭānu)	
think of as 	 గా ఆలోచించండి 	(Gā ālōcin̄caṇḍi)	
think over 	 ఆలోచించండి 	(Ālōcin̄caṇḍi)	
think up 	 ఆలోచించు 	(Ālōcin̄cu)	
third 	 మూడవది 	(Mūḍavadi)	
thirsty 	 దాహం వేసింది 	(Dāhaṁ vēsindi)	
thirteen 	 పదమూడు 	(Padamūḍu)	
thirteenth 	 పదమూడవ 	(Padamūḍava)	
thirtieth 	 ముప్పైవది 	(Muppaivadi)	
thirty 	 ముప్పై 	(Muppai)	
this 	 ఇది 	(Idi)	
thorough 	 క్షుణ్ణంగా 	(Kṣuṇṇaṅgā)	
thoroughly 	 పూర్తిగా 	(Pūrtigā)	
though 	 అయితే 	(Ayitē)	
thought 	 అనుకున్నాడు 	(Anukunnāḍu)	
thousand 	 వెయ్యి 	(Veyyi)	
thousandth 	 వెయ్యవ 	(Veyyava)	
thread 	 దారం 	(Dāraṁ)	
threat 	 బెదిరింపు 	(Bedirimpu)	
threaten 	 బెదిరిస్తారు 	(Bediristāru)	
threatening 	 బెదిరింపు 	(Bedirimpu)	
three 	 మూడు 	(Mūḍu)	
throat 	 గొంతు 	(Gontu)	
through 	 ద్వారా 	(Dvārā)	
throughout 	 అంతటా 	(Antaṭā)	
throw 	 త్రో 	(Trō)	
throw away 	 దూరంగా త్రో 	(Dūraṅgā trō)	
throw out 	 విసిరివేయండి 	(Visirivēyaṇḍi)	
thumb 	 బొటనవేలు 	(Boṭanavēlu)	
Thursday 	 గురువారం 	(Guruvāraṁ)	
thus 	 అందువలన 	(Anduvalana)	
ticket 	 టిక్కెట్టు 	(Ṭikkeṭṭu)	
tidy 	 చక్కనైన 	(Cakkanaina)	
tie 	 టై 	(Ṭai)	
tie up 	 కట్టాలి 	(Kaṭṭāli)	
tight 	 గట్టిగా 	(Gaṭṭigā)	
tightly 	 గట్టిగా 	(Gaṭṭigā)	
till 	 వరకు 	(Varaku)	
time 	 సమయం 	(Samayaṁ)	
timetable 	 కాలపట్టిక 	(Kālapaṭṭika)	
tin 	 తగరం 	(Tagaraṁ)	
tiny 	 చిన్న 	(Cinna)	
tip 	 చిట్కా 	(Ciṭkā)	
tip over 	 పైగా చిట్కా 	(Paigā ciṭkā)	
tire 	 టైర్ 	(Ṭair)	
tired 	 అలసిపోయాడు 	(Alasipōyāḍu)	
tire out 	 అలసిపోతుంది 	(Alasipōtundi)	
tiring 	 అలసిపోతుంది 	(Alasipōtundi)	
title 	 శీర్షిక 	(Śīrṣika)	
to 	 కు 	(Ku)	
today 	 నేడు 	(Nēḍu)	
toe 	 బొటనవేలు 	(Boṭanavēlu)	
together 	 కలిసి 	(Kalisi)	
toilet 	 టాయిలెట్ 	(Ṭāyileṭ)	
tomato 	 టమోటా 	(Ṭamōṭā)	
tomorrow 	 రేపు 	(Rēpu)	
ton 	 టన్ను 	(Ṭannu)	
tone 	 స్వరం 	(Svaraṁ)	
tongue 	 నాలుక 	(Nāluka)	
tonight 	 ఈ రాత్రి 	(Ī rātri)	
tonne 	 టన్ను 	(Ṭannu)	
too 	 చాలా 	(Cālā)	
tool 	 సాధనం 	(Sādhanaṁ)	
tooth 	 పంటి 	(Paṇṭi)	
top 	 టాప్ 	(Ṭāp)	
topic 	 అంశం 	(Anśaṁ)	
total 	 మొత్తం 	(Mottaṁ)	
totally 	 పూర్తిగా 	(Pūrtigā)	
touch 	 స్పర్శ 	(Sparśa)	
tough 	 కఠినమైన 	(Kaṭhinamaina)	
tour 	 పర్యటన 	(Paryaṭana)	
tourist 	 పర్యాటకుడు 	(Paryāṭakuḍu)	
towards 	 వైపు 	(Vaipu)	
towel 	 టవల్ 	(Ṭaval)	
tower 	 టవర్ 	(Ṭavar)	
town 	 పట్టణం 	(Paṭṭaṇaṁ)	
toy 	 బొమ్మ 	(Bom'ma)	
trace 	 జాడ 	(Jāḍa)	
track 	 ట్రాక్ 	(Ṭrāk)	
trade 	 వాణిజ్యం 	(Vāṇijyaṁ)	
trading 	 వర్తకం 	(Vartakaṁ)	
tradition 	 సంప్రదాయం 	(Sampradāyaṁ)	
traditional 	 సంప్రదాయ 	(Sampradāya)	
traditionally 	 సాంప్రదాయకంగా 	(Sāmpradāyakaṅgā)	
traffic 	 ట్రాఫిక్ 	(Ṭrāphik)	
train 	 రైలు 	(Railu)	
training 	 శిక్షణ 	(Śikṣaṇa)	
transfer 	 బదిలీ 	(Badilī)	
transform 	 రూపాంతరము 	(Rūpāntaramu)	
translate 	 అనువదించు 	(Anuvadin̄cu)	
translation 	 అనువాదం 	(Anuvādaṁ)	
transparent 	 పారదర్శకమైన 	(Pāradarśakamaina)	
transport 	 రవాణా 	(Ravāṇā)	
transportation 	 రవాణా 	(Ravāṇā)	
trap 	 ఉచ్చు 	(Uccu)	
travel 	 ప్రయాణం 	(Prayāṇaṁ)	
traveller 	 యాత్రికుడు 	(Yātrikuḍu)	
treat 	 చికిత్స 	(Cikitsa)	
treatment 	 చికిత్స 	(Cikitsa)	
tree 	 చెట్టు 	(Ceṭṭu)	
trend 	 ధోరణి 	(Dhōraṇi)	
trial 	 విచారణ 	(Vicāraṇa)	
triangle 	 త్రిభుజం 	(Tribhujaṁ)	
trick 	 ఉపాయం 	(Upāyaṁ)	
trip 	 యాత్ర 	(Yātra)	
tropical 	 ఉష్ణమండల 	(Uṣṇamaṇḍala)	
trouble 	 ఇబ్బంది 	(Ibbandi)	
trousers 	 ప్యాంటు 	(Pyāṇṭu)	
truck 	 ట్రక్ 	(Ṭrak)	
true 	 నిజం 	(Nijaṁ)	
truly 	 నిజంగా 	(Nijaṅgā)	
trust 	 నమ్మకం 	(Nam'makaṁ)	
truth 	 నిజం 	(Nijaṁ)	
try 	 ప్రయత్నించండి 	(Prayatnin̄caṇḍi)	
try on 	 ప్రయత్నించండి 	(Prayatnin̄caṇḍi)	
try out 	 ప్రయత్నించండి 	(Prayatnin̄caṇḍi)	
tube 	 గొట్టం 	(Goṭṭaṁ)	
Tuesday 	 మంగళవారం 	(Maṅgaḷavāraṁ)	
tune 	 ట్యూన్ 	(Ṭyūn)	
tunnel 	 సొరంగం 	(Soraṅgaṁ)	
turn 	 మలుపు 	(Malupu)	
turn back 	 వెనక్కి తిరగండి 	(Venakki tiragaṇḍi)	
turn down 	 తిరస్కరించు 	(Tiraskarin̄cu)	
turn into 	 లోకి మారుతాయి 	(Lōki mārutāyi)	
turn off 	 ఆఫ్ చేయండి 	(Āph cēyaṇḍi)	
turn on 	 ఆన్ చేయండి 	(Ān cēyaṇḍi)	
turn out 	 మారతాయి 	(Māratāyi)	
turn over 	 తిరగండి 	(Tiragaṇḍi)	
turn round 	 చుట్టూ తిరగండి 	(Cuṭṭū tiragaṇḍi)	
turn to 	 వైపు తిరగండి 	(Vaipu tiragaṇḍi)	
turn up 	 తిరగండి 	(Tiragaṇḍi)	
TV 	 టీవీ 	(Ṭīvī)	
twelfth 	 పన్నెండవది 	(Panneṇḍavadi)	
twelve 	 పన్నెండు 	(Panneṇḍu)	
twentieth 	 ఇరవయ్యవది 	(Iravayyavadi)	
twenty 	 ఇరవై 	(Iravai)	
twice 	 రెండుసార్లు 	(Reṇḍusārlu)	
twin 	 జంట 	(Jaṇṭa)	
twist 	 ట్విస్ట్ 	(Ṭvisṭ)	
twisted 	 మెలికలు తిరిగింది 	(Melikalu tirigindi)	
two 	 రెండు 	(Reṇḍu)	
type 	 రకం 	(Rakaṁ)	
typical 	 విలక్షణమైనది 	(Vilakṣaṇamainadi)	
typically 	 సాధారణంగా 	(Sādhāraṇaṅgā)	
tyre 	 టైర్ 	(Ṭair)	
the unemployed 	 నిరుద్యోగులు 	(Nirudyōgulu)	
the unexpected 	 ఊహించనిది 	(Ūhin̄canidi)	
ugly 	 వికారమైన 	(Vikāramaina)	
ultimate 	 అంతిమ 	(Antima)	
ultimately 	 చివరికి 	(Civariki)	
umbrella 	 గొడుగు 	(Goḍugu)	
unable 	 కుదరదు 	(Kudaradu)	
unacceptable 	 ఆమోదయోగ్యం కానిది 	(Āmōdayōgyaṁ kānidi)	
uncertain 	 అనిశ్చిత 	(Aniścita)	
uncle 	 మామ 	(Māma)	
uncomfortable 	 అసౌకర్యంగా 	(Asaukaryaṅgā)	
unconscious 	 అపస్మారక స్థితి 	(Apasmāraka sthiti)	
uncontrolled 	 నియంత్రణ లేని 	(Niyantraṇa lēni)	
under 	 కింద 	(Kinda)	
underground 	 భూగర్భంలో 	(Bhūgarbhanlō)	
underneath 	 కింద 	(Kinda)	
understand 	 అర్థం చేసుకుంటారు 	(Arthaṁ cēsukuṇṭāru)	
understanding 	 అవగాహన 	(Avagāhana)	
underwater 	 నీటి అడుగున 	(Nīṭi aḍuguna)	
underwear 	 లోదుస్తులు 	(Lōdustulu)	
undo 	 అన్డు 	(Anḍu)	
unemployed 	 నిరుద్యోగులు 	(Nirudyōgulu)	
unemployment 	 నిరుద్యోగం 	(Nirudyōgaṁ)	
unexpected 	 ఊహించని 	(Ūhin̄cani)	
unexpectedly 	 ఊహించని విధంగా 	(Ūhin̄cani vidhaṅgā)	
unfair 	 అన్యాయం 	(An'yāyaṁ)	
unfairly 	 అన్యాయంగా 	(An'yāyaṅgā)	
unfortunate 	 దురదృష్టకరం 	(Duradr̥ṣṭakaraṁ)	
unfortunately 	 దురదృష్టవశాత్తు 	(Duradr̥ṣṭavaśāttu)	
unfriendly 	 స్నేహరహితమైనది 	(Snēharahitamainadi)	
unhappy 	 సంతోషం లేని 	(Santōṣaṁ lēni)	
uniform 	 ఏకరీతి 	(Ēkarīti)	
unimportant 	 ప్రాముఖ్యత లేని 	(Prāmukhyata lēni)	
union 	 యూనియన్ 	(Yūniyan)	
unique 	 ఏకైక 	(Ēkaika)	
unit 	 యూనిట్ 	(Yūniṭ)	
unite 	 ఏకం చేయండి 	(Ēkaṁ cēyaṇḍi)	
united 	 ఏకమయ్యారు 	(Ēkamayyāru)	
universe 	 విశ్వం 	(Viśvaṁ)	
university 	 విశ్వవిద్యాలయం 	(Viśvavidyālayaṁ)	
unkind 	 దయలేని 	(Dayalēni)	
unknown 	 తెలియని 	(Teliyani)	
unless 	 తప్ప 	(Tappa)	
unlike 	 కాకుండా 	(Kākuṇḍā)	
unlikely 	 అసంభవం 	(Asambhavaṁ)	
unload 	 దించు 	(Din̄cu)	
unlucky 	 దురదృష్టవంతుడు 	(Duradr̥ṣṭavantuḍu)	
unnecessary 	 అనవసరమైన 	(Anavasaramaina)	
unpleasant 	 అసహ్యకరమైన 	(Asahyakaramaina)	
unreasonable 	 అసమంజసమైన 	(Asaman̄jasamaina)	
unsteady 	 అస్థిరమైన 	(Asthiramaina)	
unsuccessful 	 విజయవంతం కాలేదు 	(Vijayavantaṁ kālēdu)	
untidy 	 అపరిశుభ్రమైన 	(Apariśubhramaina)	
until 	 వరకు 	(Varaku)	
unusual 	 అసాధారణమైన 	(Asādhāraṇamaina)	
unusually 	 అసాధారణంగా 	(Asādhāraṇaṅgā)	
unwilling 	 ఇష్టంలేని 	(Iṣṭanlēni)	
unwillingly 	 ఇష్టం లేకుండా 	(Iṣṭaṁ lēkuṇḍā)	
up 	 పైకి 	(Paiki)	
upon 	 మీద 	(Mīda)	
upper 	 ఎగువ 	(Eguva)	
upset 	 కలత చెందాడు 	(Kalata cendāḍu)	
upsetting 	 కలత చెందుతోంది 	(Kalata cendutōndi)	
upside down 	 తలక్రిందులుగా 	(Talakrindulugā)	
upstairs 	 మేడమీద 	(Mēḍamīda)	
upward 	 పైకి 	(Paiki)	
upwards 	 పైకి 	(Paiki)	
urban 	 పట్టణ 	(Paṭṭaṇa)	
urge 	 కోరండి 	(Kōraṇḍi)	
urgent 	 అత్యవసరము 	(Atyavasaramu)	
us 	 మాకు 	(Māku)	
use 	 ఉపయోగించండి 	(Upayōgin̄caṇḍi)	
used 1 	 ఉపయోగించిన 1 	(Upayōgin̄cina 1)	
used 2 	 ఉపయోగించిన 2 	(Upayōgin̄cina 2)	
used to 	 ఉపయోగిస్తారు 	(Upayōgistāru)	
useful 	 ఉపయోగకరమైన 	(Upayōgakaramaina)	
useless 	 పనికిరానిది 	(Panikirānidi)	
user 	 వినియోగదారు 	(Viniyōgadāru)	
use up 	 అప్ ఉపయోగించండి 	(Ap upayōgin̄caṇḍi)	
usual 	 సాధారణ 	(Sādhāraṇa)	
usually 	 సాధారణంగా 	(Sādhāraṇaṅgā)	
vacation 	 సెలవు 	(Selavu)	
valid 	 చెల్లుతుంది 	(Cellutundi)	
valley 	 లోయ 	(Lōya)	
valuable 	 విలువైన 	(Viluvaina)	
value 	 విలువ 	(Viluva)	
van 	 వ్యాను 	(Vyānu)	
variation 	 వైవిధ్యం 	(Vaividhyaṁ)	
varied 	 వైవిధ్యమైనది 	(Vaividhyamainadi)	
variety 	 వివిధ 	(Vividha)	
various 	 వివిధ 	(Vividha)	
vary 	 మారుతూ ఉంటాయి 	(Mārutū uṇṭāyi)	
vast 	 విశాలమైనది 	(Viśālamainadi)	
vegetable 	 కూరగాయల 	(Kūragāyala)	
vehicle 	 వాహనం 	(Vāhanaṁ)	
venture 	 వెంచర్ 	(Ven̄car)	
version 	 వెర్షన్ 	(Verṣan)	
vertical 	 నిలువు 	(Niluvu)	
very 	 చాలా 	(Cālā)	
via 	 ద్వారా 	(Dvārā)	
victim 	 బాధితుడు 	(Bādhituḍu)	
victory 	 విజయం 	(Vijayaṁ)	
video 	 వీడియో 	(Vīḍiyō)	
view 	 వీక్షణ 	(Vīkṣaṇa)	
village 	 గ్రామం 	(Grāmaṁ)	
violence 	 హింస 	(Hinsa)	
violent 	 హింసాత్మకమైన 	(Hinsātmakamaina)	
violently 	 హింసాత్మకంగా 	(Hinsātmakaṅgā)	
virtually 	 వాస్తవంగా 	(Vāstavaṅgā)	
virus 	 వైరస్ 	(Vairas)	
visible 	 కనిపించే 	(Kanipin̄cē)	
vision 	 దృష్టి 	(Dr̥ṣṭi)	
visit 	 సందర్శించండి 	(Sandarśin̄caṇḍi)	
visitor 	 సందర్శకుడు 	(Sandarśakuḍu)	
vital 	 ప్రాణాధారమైన 	(Prāṇādhāramaina)	
vocabulary 	 పదజాలం 	(Padajālaṁ)	
voice 	 వాయిస్ 	(Vāyis)	
volume 	 వాల్యూమ్ 	(Vālyūm)	
vote 	 ఓటు వేయండి 	(Ōṭu vēyaṇḍi)	
wage 	 వేతనం 	(Vētanaṁ)	
waist 	 నడుము 	(Naḍumu)	
wait 	 వేచి ఉండండి 	(Vēci uṇḍaṇḍi)	
waiter 	 వెయిటర్ 	(Veyiṭar)	
wake 	 మేల్కొలపండి 	(Mēlkolapaṇḍi)	
walk 	 నడవండి 	(Naḍavaṇḍi)	
walking 	 నడవడం 	(Naḍavaḍaṁ)	
walk out 	 బయటకు నడవండి 	(Bayaṭaku naḍavaṇḍi)	
walk up 	 పైకి నడవండి 	(Paiki naḍavaṇḍi)	
wall 	 గోడ 	(Gōḍa)	
wallet 	 వాలెట్ 	(Vāleṭ)	
wander 	 సంచరించు 	(San̄carin̄cu)	
want 	 కావాలి 	(Kāvāli)	
war 	 యుద్ధం 	(Yud'dhaṁ)	
warm 	 వెచ్చని 	(Veccani)	
warmth 	 వెచ్చదనం 	(Veccadanaṁ)	
warm up 	 వేడెక్కుతుంది 	(Vēḍekkutundi)	
warn 	 హెచ్చరిస్తారు 	(Heccaristāru)	
warning 	 హెచ్చరిక 	(Heccarika)	
wash 	 కడగడం 	(Kaḍagaḍaṁ)	
wash away 	 కొట్టుకుపోతాయి 	(Koṭṭukupōtāyi)	
washing 	 కడగడం 	(Kaḍagaḍaṁ)	
wash off 	 కడగడం 	(Kaḍagaḍaṁ)	
wash out 	 వాష్ అవుట్ 	(Vāṣ avuṭ)	
wash up 	 కడగడం 	(Kaḍagaḍaṁ)	
waste 	 వ్యర్థం 	(Vyarthaṁ)	
watch 	 వాచ్ 	(Vāc)	
watch out 	 జాగ్రత్తగా ఉండు 	(Jāgrattagā uṇḍu)	
watch out for 	 కోసం చూడండి 	(Kōsaṁ cūḍaṇḍi)	
water 	 నీరు 	(Nīru)	
wave 	 అల 	(Ala)	
way 	 మార్గం 	(Mārgaṁ)	
we 	 మేము 	(Mēmu)	
weak 	 బలహీనమైన 	(Balahīnamaina)	
weakness 	 బలహీనత 	(Balahīnata)	
wealth 	 సంపద 	(Sampada)	
weapon 	 ఆయుధం 	(Āyudhaṁ)	
wear 	 ధరిస్తారు 	(Dharistāru)	
wear away 	 ధరిస్తారు 	(Dharistāru)	
wear off 	 ధరిస్తారు 	(Dharistāru)	
wear out 	 అరిగిపోతాయి 	(Arigipōtāyi)	
weather 	 వాతావరణం 	(Vātāvaraṇaṁ)	
web 	 వెబ్ 	(Veb)	
website 	 వెబ్సైట్ 	(Vebsaiṭ)	
wedding 	 పెళ్లి 	(Peḷli)	
Wednesday 	 బుధవారం 	(Budhavāraṁ)	
week 	 వారం 	(Vāraṁ)	
weekend 	 వారాంతం 	(Vārāntaṁ)	
weekly 	 వారానికోసారి 	(Vārānikōsāri)	
weigh 	 బరువు 	(Baruvu)	
weight 	 బరువు 	(Baruvu)	
welcome 	 స్వాగతం 	(Svāgataṁ)	
well 	 బాగా 	(Bāgā)	
well known 	 బాగా తెలిసిన 	(Bāgā telisina)	
west 	 పడమర 	(Paḍamara)	
western 	 పశ్చిమ 	(Paścima)	
wet 	 తడి 	(Taḍi)	
what 	 ఏమి 	(Ēmi)	
whatever 	 ఏమైనా 	(Ēmainā)	
wheel 	 చక్రం 	(Cakraṁ)	
when 	 ఎప్పుడు 	(Eppuḍu)	
whenever 	 ఎప్పుడైనా 	(Eppuḍainā)	
where 	 ఎక్కడ 	(Ekkaḍa)	
whereas 	 కాగా 	(Kāgā)	
wherever 	 ఎక్కడైనా 	(Ekkaḍainā)	
whether 	 లేదో 	(Lēdō)	
which 	 ఏది 	(Ēdi)	
while 	 అయితే 	(Ayitē)	
whisper 	 గుసగుసలు 	(Gusagusalu)	
whistle 	 విజిల్ 	(Vijil)	
white 	 తెలుపు 	(Telupu)	
who 	 WHO 	(WHO)	
whoever 	 ఎవరైనా 	(Evarainā)	
whole 	 మొత్తం 	(Mottaṁ)	
whom 	 ఎవరిని 	(Evarini)	
whose 	 ఎవరిది 	(Evaridi)	
why 	 ఎందుకు 	(Enduku)	
wide 	 వెడల్పు 	(Veḍalpu)	
widely 	 విస్తృతంగా 	(Vistr̥taṅgā)	
width 	 వెడల్పు 	(Veḍalpu)	
wife 	 భార్య 	(Bhārya)	
wild 	 అడవి 	(Aḍavi)	
wildly 	 క్రూరంగా 	(Krūraṅgā)	
will 	 రెడీ 	(Reḍī)	
willing 	 సిద్ధమయ్యారు 	(Sid'dhamayyāru)	
willingly 	 ఇష్టపూర్వకంగా 	(Iṣṭapūrvakaṅgā)	
willingness 	 సుముఖత 	(Sumukhata)	
win 	 గెలుస్తారు 	(Gelustāru)	
wind 1 	 గాలి 1 	(Gāli 1)	
wind 2 	 గాలి 2 	(Gāli 2)	
window 	 కిటికీ 	(Kiṭikī)	
wine 	 వైన్ 	(Vain)	
wing 	 రెక్క 	(Rekka)	
winner 	 విజేత 	(Vijēta)	
winning 	 గెలుస్తోంది 	(Gelustōndi)	
winter 	 చలికాలం 	(Calikālaṁ)	
wire 	 తీగ 	(Tīga)	
wise 	 తెలివైనవాడు 	(Telivainavāḍu)	
wish 	 కోరిక 	(Kōrika)	
with 	 తో 	(Tō)	
withdraw 	 ఉపసంహరించుకోండి 	(Upasanharin̄cukōṇḍi)	
within 	 లోపల 	(Lōpala)	
without 	 లేకుండా 	(Lēkuṇḍā)	
witness 	 సాక్షి 	(Sākṣi)	
woman 	 స్త్రీ 	(Strī)	
wonder 	 ఆశ్చర్యం 	(Āścaryaṁ)	
wonderful 	 అద్భుతమైన 	(Adbhutamaina)	
wood 	 చెక్క 	(Cekka)	
wooden 	 చెక్క 	(Cekka)	
wool 	 ఉన్ని 	(Unni)	
word 	 పదం 	(Padaṁ)	
work 	 పని 	(Pani)	
worker 	 కార్మికుడు 	(Kārmikuḍu)	
working 	 పని చేస్తున్నారు 	(Pani cēstunnāru)	
work out 	 పని చేయండి 	(Pani cēyaṇḍi)	
world 	 ప్రపంచం 	(Prapan̄caṁ)	
worried 	 ఆందోళన చెందాడు 	(Āndōḷana cendāḍu)	
worry 	 ఆందోళన 	(Āndōḷana)	
worrying 	 చింతిస్తూ 	(Cintistū)	
worse 	 అధ్వాన్నంగా 	(Adhvānnaṅgā)	
worship 	 పూజించండి 	(Pūjin̄caṇḍi)	
worst 	 చెత్త 	(Cetta)	
worth 	 విలువ 	(Viluva)	
would 	 ఉంటుంది 	(Uṇṭundi)	
wound 1 	 గాయం 1 	(Gāyaṁ 1)	
wounded 	 గాయపడ్డాడు 	(Gāyapaḍḍāḍu)	
wrap 	 చుట్టు 	(Cuṭṭu)	
wrapping 	 చుట్టడం 	(Cuṭṭaḍaṁ)	
wrist 	 మణికట్టు 	(Maṇikaṭṭu)	
write 	 వ్రాయండి 	(Vrāyaṇḍi)	
write back 	 తిరిగి వ్రాయండి 	(Tirigi vrāyaṇḍi)	
write down 	 వ్రాయండి 	(Vrāyaṇḍi)	
writer 	 రచయిత 	(Racayita)	
writing 	 రాయడం 	(Rāyaḍaṁ)	
written 	 వ్రాయబడింది 	(Vrāyabaḍindi)	
wrong 	 తప్పు 	(Tappu)	
wrongly 	 తప్పుగా 	(Tappugā)	
yard 	 యార్డ్ 	(Yārḍ)	
yawn 	 ఆవలించు 	(Āvalin̄cu)	
yeah 	 అవును 	(Avunu)	
year 	 సంవత్సరం 	(Sanvatsaraṁ)	
yellow 	 పసుపు 	(Pasupu)	
yes 	 అవును 	(Avunu)	
yesterday 	 నిన్న 	(Ninna)	
yet 	 ఇంకా 	(Iṅkā)	
you 	 మీరు 	(Mīru)	
young 	 యువకుడు 	(Yuvakuḍu)	
your 	 మీ 	(Mī)	
yours 	 మీది 	(Mīdi)	
yourself 	 మీరే 	(Mīrē)	
youth 	 యువత 	(Yuvata)	
zero 	 సున్నా 	(Sunnā)	
zone 	 జోన్ 	(Jōn)	
=== end == 	 === ముగింపు == 	(=== Mugimpu ==)	
